"SiteID","SiteName","Latitude","Longitude","SpeciesID","SpeciesDesc","Kingdom","SpeciesType","PhenophaseID","PhenophaseCategory","PhenophaseDesc","Year","FirstYes","LastYes","NumLastNo","NumFirstNo","LastNo","FirstNo","TotDays"
27474,"Visitor Center Trail",29.784473,-90.114784,2,"boxelder","Plantae","Deciduous broadleaf",471,"Leaves","Falling leaves",2017,324,324,25,0,299,324,25
27474,"Visitor Center Trail",29.784473,-90.114784,81,"sweetgum","Plantae","Deciduous broadleaf",467,"Leaves","Increasing leaf size",2017,355,355,1,2,354,357,3
27474,"Visitor Center Trail",29.784473,-90.114784,81,"sweetgum","Plantae","Deciduous broadleaf",471,"Leaves","Falling leaves",2017,306,306,7,0,299,306,7
27474,"Visitor Center Trail",29.784473,-90.114784,81,"sweetgum","Plantae","Deciduous broadleaf",498,"Leaves","Colored leaves",2017,322,324,23,30,299,354,55
27474,"Visitor Center Trail",29.784473,-90.114784,81,"sweetgum","Plantae","Deciduous broadleaf",501,"Flowers","Open flowers",2017,354,354,30,1,324,355,31
27474,"Visitor Center Trail",29.784473,-90.114784,81,"sweetgum","Plantae","Deciduous broadleaf",504,"Fruits","Recent fruit or seed drop",2017,245,322,14,2,231,324,93
27474,"Visitor Center Trail",29.784473,-90.114784,81,"sweetgum","Plantae","Deciduous broadleaf",516,"Fruits","Fruits",2017,324,355,2,2,322,357,35
27474,"Visitor Center Trail",29.784473,-90.114784,201,"common buttonbush","Plantae","Deciduous broadleaf",390,"Fruits","Ripe fruits",2017,245,245,14,0,231,245,14
27474,"Visitor Center Trail",29.784473,-90.114784,201,"common buttonbush","Plantae","Deciduous broadleaf",471,"Leaves","Falling leaves",2017,263,322,18,2,245,324,79
27474,"Visitor Center Trail",29.784473,-90.114784,201,"common buttonbush","Plantae","Deciduous broadleaf",498,"Leaves","Colored leaves",2017,263,322,18,2,245,324,79
27474,"Visitor Center Trail",29.784473,-90.114784,201,"common buttonbush","Plantae","Deciduous broadleaf",500,"Flowers","Flowers or flower buds",2017,299,299,0,7,299,306,7
27474,"Visitor Center Trail",29.784473,-90.114784,201,"common buttonbush","Plantae","Deciduous broadleaf",501,"Flowers","Open flowers",2017,299,299,0,7,299,306,7
27474,"Visitor Center Trail",29.784473,-90.114784,201,"common buttonbush","Plantae","Deciduous broadleaf",504,"Fruits","Recent fruit or seed drop",2017,245,322,14,2,231,324,93
27474,"Visitor Center Trail",29.784473,-90.114784,201,"common buttonbush","Plantae","Deciduous broadleaf",516,"Fruits","Fruits",2017,355,355,1,2,354,357,3
27474,"Visitor Center Trail",29.784473,-90.114784,208,"white crownbeard","Plantae","Forb",482,"Leaves","Initial growth (forbs)",2017,324,324,25,30,299,354,55
27474,"Visitor Center Trail",29.784473,-90.114784,208,"white crownbeard","Plantae","Forb",500,"Flowers","Flowers or flower buds",2017,324,324,0,30,324,354,30
27474,"Visitor Center Trail",29.784473,-90.114784,208,"white crownbeard","Plantae","Forb",501,"Flowers","Open flowers",2017,324,324,0,30,324,354,30
27474,"Visitor Center Trail",29.784473,-90.114784,208,"white crownbeard","Plantae","Forb",504,"Fruits","Recent fruit or seed drop",2017,354,354,30,0,324,354,30
27474,"Visitor Center Trail",29.784473,-90.114784,296,"bald cypress","Plantae","Deciduous conifer",393,"Seed cones","Ripe seed cones",2017,245,245,14,0,231,245,14
27474,"Visitor Center Trail",29.784473,-90.114784,296,"bald cypress","Plantae","Deciduous conifer",472,"Needles","Falling needles",2017,245,245,14,0,231,245,14
27474,"Visitor Center Trail",29.784473,-90.114784,296,"bald cypress","Plantae","Deciduous conifer",490,"Pollen cones","Pollen cones (conifers)",2017,231,231,0,14,231,245,14
27474,"Visitor Center Trail",29.784473,-90.114784,296,"bald cypress","Plantae","Deciduous conifer",491,"Seed cones","Recent cone or seed drop",2017,245,245,14,0,231,245,14
27474,"Visitor Center Trail",29.784473,-90.114784,296,"bald cypress","Plantae","Deciduous conifer",495,"Pollen cones","Open pollen cones (conifers)",2017,299,299,0,23,299,322,23
27474,"Visitor Center Trail",29.784473,-90.114784,309,"trumpet creeper","Plantae","Deciduous broadleaf",390,"Fruits","Ripe fruits",2017,324,324,0,30,324,354,30
27474,"Visitor Center Trail",29.784473,-90.114784,309,"trumpet creeper","Plantae","Deciduous broadleaf",471,"Leaves","Falling leaves",2017,324,324,2,30,322,354,32
27474,"Visitor Center Trail",29.784473,-90.114784,309,"trumpet creeper","Plantae","Deciduous broadleaf",483,"Leaves","Leaves",2017,324,324,0,30,324,354,30
27474,"Visitor Center Trail",29.784473,-90.114784,309,"trumpet creeper","Plantae","Deciduous broadleaf",498,"Leaves","Colored leaves",2017,324,324,0,30,324,354,30
27474,"Visitor Center Trail",29.784473,-90.114784,309,"trumpet creeper","Plantae","Deciduous broadleaf",516,"Fruits","Fruits",2017,324,324,0,30,324,354,30
27474,"Visitor Center Trail",29.784473,-90.114784,722,"wax myrtle","Plantae","Evergreen broadleaf",484,"Leaves","Young leaves (tree/shrub)",2017,322,355,16,2,306,357,51
27474,"Visitor Center Trail",29.784473,-90.114784,722,"wax myrtle","Plantae","Evergreen broadleaf",500,"Flowers","Flowers or flower buds",2017,322,322,16,2,306,324,18
27474,"Visitor Center Trail",29.784473,-90.114784,722,"wax myrtle","Plantae","Evergreen broadleaf",504,"Fruits","Recent fruit or seed drop",2017,299,299,0,7,299,306,7
27474,"Visitor Center Trail",29.784473,-90.114784,722,"wax myrtle","Plantae","Evergreen broadleaf",516,"Fruits","Fruits",2017,324,324,2,30,322,354,32
27474,"Visitor Center Trail",29.784473,-90.114784,804,"eastern baccharis","Plantae","Deciduous broadleaf",371,"Leaves","Breaking leaf buds",2017,322,322,23,2,299,324,25
27474,"Visitor Center Trail",29.784473,-90.114784,804,"eastern baccharis","Plantae","Deciduous broadleaf",390,"Fruits","Ripe fruits",2017,322,324,23,30,299,354,55
27474,"Visitor Center Trail",29.784473,-90.114784,804,"eastern baccharis","Plantae","Deciduous broadleaf",467,"Leaves","Increasing leaf size",2017,322,322,23,2,299,324,25
27474,"Visitor Center Trail",29.784473,-90.114784,804,"eastern baccharis","Plantae","Deciduous broadleaf",471,"Leaves","Falling leaves",2017,322,354,23,3,299,357,58
27474,"Visitor Center Trail",29.784473,-90.114784,804,"eastern baccharis","Plantae","Deciduous broadleaf",498,"Leaves","Colored leaves",2017,322,322,23,2,299,324,25
27474,"Visitor Center Trail",29.784473,-90.114784,804,"eastern baccharis","Plantae","Deciduous broadleaf",504,"Fruits","Recent fruit or seed drop",2017,322,322,23,2,299,324,25
27474,"Visitor Center Trail",29.784473,-90.114784,804,"eastern baccharis","Plantae","Deciduous broadleaf",516,"Fruits","Fruits",2017,322,324,23,30,299,354,55
27475,"Palmetto Trail",29.783813,-90.117561,3,"red maple","Plantae","Deciduous broadleaf",471,"Leaves","Falling leaves",2017,324,324,2,30,322,354,32
27475,"Palmetto Trail",29.783813,-90.117561,81,"sweetgum","Plantae","Deciduous broadleaf",467,"Leaves","Increasing leaf size",2017,355,355,1,0,354,355,1
27475,"Palmetto Trail",29.783813,-90.117561,81,"sweetgum","Plantae","Deciduous broadleaf",471,"Leaves","Falling leaves",2017,322,322,16,2,306,324,18
27475,"Palmetto Trail",29.783813,-90.117561,296,"bald cypress","Plantae","Deciduous conifer",392,"Seed cones","Unripe seed cones",2017,299,299,0,23,299,322,23
27475,"Palmetto Trail",29.783813,-90.117561,296,"bald cypress","Plantae","Deciduous conifer",393,"Seed cones","Ripe seed cones",2017,355,355,1,0,354,355,1
27475,"Palmetto Trail",29.783813,-90.117561,296,"bald cypress","Plantae","Deciduous conifer",487,"Needles","Needles (deciduous)",2017,354,354,0,1,354,355,1
27475,"Palmetto Trail",29.783813,-90.117561,296,"bald cypress","Plantae","Deciduous conifer",490,"Pollen cones","Pollen cones (conifers)",2017,299,299,0,7,299,306,7
27475,"Palmetto Trail",29.783813,-90.117561,296,"bald cypress","Plantae","Deciduous conifer",495,"Pollen cones","Open pollen cones (conifers)",2017,299,299,0,7,299,306,7
27475,"Palmetto Trail",29.783813,-90.117561,305,"live oak","Plantae","Semi-evergreen broadleaf",471,"Leaves","Falling leaves",2017,324,324,2,30,322,354,32
27475,"Palmetto Trail",29.783813,-90.117561,309,"trumpet creeper","Plantae","Deciduous broadleaf",467,"Leaves","Increasing leaf size",2017,355,355,1,0,354,355,1
27475,"Palmetto Trail",29.783813,-90.117561,309,"trumpet creeper","Plantae","Deciduous broadleaf",471,"Leaves","Falling leaves",2017,324,324,2,0,322,324,2
27475,"Palmetto Trail",29.783813,-90.117561,309,"trumpet creeper","Plantae","Deciduous broadleaf",498,"Leaves","Colored leaves",2017,322,354,23,1,299,355,56
27475,"Palmetto Trail",29.783813,-90.117561,940,"water tupelo ","Plantae","Deciduous broadleaf",390,"Fruits","Ripe fruits",2017,322,322,16,2,306,324,18
27475,"Palmetto Trail",29.783813,-90.117561,940,"water tupelo ","Plantae","Deciduous broadleaf",471,"Leaves","Falling leaves",2017,299,324,5,30,294,354,60
27475,"Palmetto Trail",29.783813,-90.117561,940,"water tupelo ","Plantae","Deciduous broadleaf",483,"Leaves","Leaves",2017,324,324,0,30,324,354,30
27475,"Palmetto Trail",29.783813,-90.117561,940,"water tupelo ","Plantae","Deciduous broadleaf",498,"Leaves","Colored leaves",2017,322,324,16,30,306,354,48
27475,"Palmetto Trail",29.783813,-90.117561,940,"water tupelo ","Plantae","Deciduous broadleaf",504,"Fruits","Recent fruit or seed drop",2017,299,322,5,2,294,324,30
27475,"Palmetto Trail",29.783813,-90.117561,940,"water tupelo ","Plantae","Deciduous broadleaf",516,"Fruits","Fruits",2017,322,322,16,2,306,324,18
27475,"Palmetto Trail",29.783813,-90.117561,1044,"eastern poison ivy","Plantae","Deciduous broadleaf",467,"Leaves","Increasing leaf size",2017,355,355,1,0,354,355,1
27475,"Palmetto Trail",29.783813,-90.117561,1044,"eastern poison ivy","Plantae","Deciduous broadleaf",471,"Leaves","Falling leaves",2017,324,324,2,30,322,354,32
27475,"Palmetto Trail",29.783813,-90.117561,1616,"possumhaw","Plantae","Deciduous broadleaf",471,"Leaves","Falling leaves",2017,324,324,2,30,322,354,32
27475,"Palmetto Trail",29.783813,-90.117561,1616,"possumhaw","Plantae","Deciduous broadleaf",498,"Leaves","Colored leaves",2017,322,324,16,30,306,354,48
27476,"Ring Levee Trail",29.785265,-90.110191,2,"boxelder","Plantae","Deciduous broadleaf",501,"Flowers","Open flowers",2017,298,298,11,25,287,323,36
27476,"Ring Levee Trail",29.785265,-90.110191,2,"boxelder","Plantae","Deciduous broadleaf",504,"Fruits","Recent fruit or seed drop",2017,259,259,6,28,253,287,34
27476,"Ring Levee Trail",29.785265,-90.110191,3,"red maple","Plantae","Deciduous broadleaf",467,"Leaves","Increasing leaf size",2017,259,259,6,0,253,259,6
27476,"Ring Levee Trail",29.785265,-90.110191,81,"sweetgum","Plantae","Deciduous broadleaf",504,"Fruits","Recent fruit or seed drop",2017,341,341,18,0,323,341,18
27476,"Ring Levee Trail",29.785265,-90.110191,296,"bald cypress","Plantae","Deciduous conifer",392,"Seed cones","Unripe seed cones",2017,323,323,0,18,323,341,18
27476,"Ring Levee Trail",29.785265,-90.110191,296,"bald cypress","Plantae","Deciduous conifer",393,"Seed cones","Ripe seed cones",2017,259,259,6,0,253,259,6
27476,"Ring Levee Trail",29.785265,-90.110191,296,"bald cypress","Plantae","Deciduous conifer",490,"Pollen cones","Pollen cones (conifers)",2017,287,287,0,11,287,298,11
27476,"Ring Levee Trail",29.785265,-90.110191,305,"live oak","Plantae","Semi-evergreen broadleaf",471,"Leaves","Falling leaves",2017,259,298,6,25,253,323,70
27476,"Ring Levee Trail",29.785265,-90.110191,305,"live oak","Plantae","Semi-evergreen broadleaf",504,"Fruits","Recent fruit or seed drop",2017,259,323,6,18,253,341,88
27476,"Ring Levee Trail",29.785265,-90.110191,309,"trumpet creeper","Plantae","Deciduous broadleaf",390,"Fruits","Ripe fruits",2017,287,287,28,11,259,298,39
27476,"Ring Levee Trail",29.785265,-90.110191,309,"trumpet creeper","Plantae","Deciduous broadleaf",467,"Leaves","Increasing leaf size",2017,245,245,0,8,245,253,8
27476,"Ring Levee Trail",29.785265,-90.110191,309,"trumpet creeper","Plantae","Deciduous broadleaf",471,"Leaves","Falling leaves",2017,298,298,11,0,287,298,11
27476,"Ring Levee Trail",29.785265,-90.110191,309,"trumpet creeper","Plantae","Deciduous broadleaf",500,"Flowers","Flowers or flower buds",2017,259,259,0,28,259,287,28
27476,"Ring Levee Trail",29.785265,-90.110191,309,"trumpet creeper","Plantae","Deciduous broadleaf",501,"Flowers","Open flowers",2017,253,253,0,6,253,259,6
27476,"Ring Levee Trail",29.785265,-90.110191,309,"trumpet creeper","Plantae","Deciduous broadleaf",516,"Fruits","Fruits",2017,259,259,6,28,253,287,34
27476,"Ring Levee Trail",29.785265,-90.110191,722,"wax myrtle","Plantae","Evergreen broadleaf",371,"Leaves","Breaking leaf buds",2017,287,287,0,11,287,298,11
27476,"Ring Levee Trail",29.785265,-90.110191,722,"wax myrtle","Plantae","Evergreen broadleaf",390,"Fruits","Ripe fruits",2017,259,259,6,0,253,259,6
27476,"Ring Levee Trail",29.785265,-90.110191,722,"wax myrtle","Plantae","Evergreen broadleaf",484,"Leaves","Young leaves (tree/shrub)",2017,287,287,0,11,287,298,11
27476,"Ring Levee Trail",29.785265,-90.110191,885,"honeylocust","Plantae","Deciduous broadleaf",390,"Fruits","Ripe fruits",2017,287,287,28,11,259,298,39
27476,"Ring Levee Trail",29.785265,-90.110191,885,"honeylocust","Plantae","Deciduous broadleaf",467,"Leaves","Increasing leaf size",2017,287,287,28,0,259,287,28
27476,"Ring Levee Trail",29.785265,-90.110191,885,"honeylocust","Plantae","Deciduous broadleaf",471,"Leaves","Falling leaves",2017,253,287,8,11,245,298,53
27476,"Ring Levee Trail",29.785265,-90.110191,885,"honeylocust","Plantae","Deciduous broadleaf",498,"Leaves","Colored leaves",2017,253,287,8,11,245,298,53
27476,"Ring Levee Trail",29.785265,-90.110191,885,"honeylocust","Plantae","Deciduous broadleaf",516,"Fruits","Fruits",2017,287,287,28,11,259,298,39
27476,"Ring Levee Trail",29.785265,-90.110191,1044,"eastern poison ivy","Plantae","Deciduous broadleaf",390,"Fruits","Ripe fruits",2017,259,259,0,28,259,287,28
27476,"Ring Levee Trail",29.785265,-90.110191,1044,"eastern poison ivy","Plantae","Deciduous broadleaf",516,"Fruits","Fruits",2017,259,259,0,28,259,287,28
27476,"Ring Levee Trail",29.785265,-90.110191,1616,"possumhaw","Plantae","Deciduous broadleaf",390,"Fruits","Ripe fruits",2017,323,323,25,0,298,323,25
27476,"Ring Levee Trail",29.785265,-90.110191,1616,"possumhaw","Plantae","Deciduous broadleaf",500,"Flowers","Flowers or flower buds",2017,298,298,11,25,287,323,36
27476,"Ring Levee Trail",29.785265,-90.110191,1616,"possumhaw","Plantae","Deciduous broadleaf",516,"Fruits","Fruits",2017,298,298,11,0,287,298,11
27477,"Bayou Coquille Trail",29.793816,-90.122452,81,"sweetgum","Plantae","Deciduous broadleaf",371,"Leaves","Breaking leaf buds",2017,345,345,16,10,329,355,26
27477,"Bayou Coquille Trail",29.793816,-90.122452,81,"sweetgum","Plantae","Deciduous broadleaf",467,"Leaves","Increasing leaf size",2017,355,355,10,0,345,355,10
27477,"Bayou Coquille Trail",29.793816,-90.122452,81,"sweetgum","Plantae","Deciduous broadleaf",504,"Fruits","Recent fruit or seed drop",2017,325,325,24,4,301,329,28
27477,"Bayou Coquille Trail",29.793816,-90.122452,81,"sweetgum","Plantae","Deciduous broadleaf",516,"Fruits","Fruits",2017,310,310,9,12,301,322,21
27477,"Bayou Coquille Trail",29.793816,-90.122452,201,"common buttonbush","Plantae","Deciduous broadleaf",467,"Leaves","Increasing leaf size",2017,322,322,26,3,296,325,29
27477,"Bayou Coquille Trail",29.793816,-90.122452,201,"common buttonbush","Plantae","Deciduous broadleaf",471,"Leaves","Falling leaves",2017,325,329,3,16,322,345,23
27477,"Bayou Coquille Trail",29.793816,-90.122452,201,"common buttonbush","Plantae","Deciduous broadleaf",483,"Leaves","Leaves",2017,329,329,0,16,329,345,16
27477,"Bayou Coquille Trail",29.793816,-90.122452,201,"common buttonbush","Plantae","Deciduous broadleaf",498,"Leaves","Colored leaves",2017,329,329,0,16,329,345,16
27477,"Bayou Coquille Trail",29.793816,-90.122452,201,"common buttonbush","Plantae","Deciduous broadleaf",504,"Fruits","Recent fruit or seed drop",2017,322,325,12,4,310,329,19
27477,"Bayou Coquille Trail",29.793816,-90.122452,296,"bald cypress","Plantae","Deciduous conifer",392,"Seed cones","Unripe seed cones",2017,329,329,4,16,325,345,20
27477,"Bayou Coquille Trail",29.793816,-90.122452,296,"bald cypress","Plantae","Deciduous conifer",490,"Pollen cones","Pollen cones (conifers)",2017,296,296,0,5,296,301,5
27477,"Bayou Coquille Trail",29.793816,-90.122452,296,"bald cypress","Plantae","Deciduous conifer",491,"Seed cones","Recent cone or seed drop",2017,325,325,3,0,322,325,3
27477,"Bayou Coquille Trail",29.793816,-90.122452,296,"bald cypress","Plantae","Deciduous conifer",495,"Pollen cones","Open pollen cones (conifers)",2017,296,296,0,5,296,301,5
27477,"Bayou Coquille Trail",29.793816,-90.122452,305,"live oak","Plantae","Semi-evergreen broadleaf",471,"Leaves","Falling leaves",2017,355,355,10,0,345,355,10
27477,"Bayou Coquille Trail",29.793816,-90.122452,305,"live oak","Plantae","Semi-evergreen broadleaf",484,"Leaves","Young leaves (tree/shrub)",2017,355,355,30,0,325,355,30
27477,"Bayou Coquille Trail",29.793816,-90.122452,305,"live oak","Plantae","Semi-evergreen broadleaf",498,"Leaves","Colored leaves",2017,310,322,9,3,301,325,24
27477,"Bayou Coquille Trail",29.793816,-90.122452,309,"trumpet creeper","Plantae","Deciduous broadleaf",390,"Fruits","Ripe fruits",2017,325,325,3,4,322,329,7
27477,"Bayou Coquille Trail",29.793816,-90.122452,309,"trumpet creeper","Plantae","Deciduous broadleaf",471,"Leaves","Falling leaves",2017,301,329,5,16,296,345,49
27477,"Bayou Coquille Trail",29.793816,-90.122452,309,"trumpet creeper","Plantae","Deciduous broadleaf",483,"Leaves","Leaves",2017,345,345,0,10,345,355,10
27477,"Bayou Coquille Trail",29.793816,-90.122452,309,"trumpet creeper","Plantae","Deciduous broadleaf",498,"Leaves","Colored leaves",2017,301,345,5,10,296,355,59
27477,"Bayou Coquille Trail",29.793816,-90.122452,309,"trumpet creeper","Plantae","Deciduous broadleaf",500,"Flowers","Flowers or flower buds",2017,325,325,3,4,322,329,7
27477,"Bayou Coquille Trail",29.793816,-90.122452,309,"trumpet creeper","Plantae","Deciduous broadleaf",504,"Fruits","Recent fruit or seed drop",2017,325,325,3,4,322,329,7
27477,"Bayou Coquille Trail",29.793816,-90.122452,309,"trumpet creeper","Plantae","Deciduous broadleaf",516,"Fruits","Fruits",2017,301,325,5,4,296,329,33
27477,"Bayou Coquille Trail",29.793816,-90.122452,722,"wax myrtle","Plantae","Evergreen broadleaf",390,"Fruits","Ripe fruits",2017,345,345,0,10,345,355,10
27477,"Bayou Coquille Trail",29.793816,-90.122452,722,"wax myrtle","Plantae","Evergreen broadleaf",484,"Leaves","Young leaves (tree/shrub)",2017,355,355,10,0,345,355,10
27477,"Bayou Coquille Trail",29.793816,-90.122452,804,"eastern baccharis","Plantae","Deciduous broadleaf",390,"Fruits","Ripe fruits",2017,329,329,0,16,329,345,16
27477,"Bayou Coquille Trail",29.793816,-90.122452,804,"eastern baccharis","Plantae","Deciduous broadleaf",471,"Leaves","Falling leaves",2017,345,345,16,0,329,345,16
27477,"Bayou Coquille Trail",29.793816,-90.122452,804,"eastern baccharis","Plantae","Deciduous broadleaf",498,"Leaves","Colored leaves",2017,345,345,16,10,329,355,26
27477,"Bayou Coquille Trail",29.793816,-90.122452,804,"eastern baccharis","Plantae","Deciduous broadleaf",500,"Flowers","Flowers or flower buds",2017,296,296,0,5,296,301,5
27477,"Bayou Coquille Trail",29.793816,-90.122452,804,"eastern baccharis","Plantae","Deciduous broadleaf",504,"Fruits","Recent fruit or seed drop",2017,301,301,5,0,296,301,5
27477,"Bayou Coquille Trail",29.793816,-90.122452,804,"eastern baccharis","Plantae","Deciduous broadleaf",516,"Fruits","Fruits",2017,329,329,0,16,329,345,16
27477,"Bayou Coquille Trail",29.793816,-90.122452,940,"water tupelo ","Plantae","Deciduous broadleaf",498,"Leaves","Colored leaves",2017,301,322,5,3,296,325,29
27477,"Bayou Coquille Trail",29.793816,-90.122452,940,"water tupelo ","Plantae","Deciduous broadleaf",504,"Fruits","Recent fruit or seed drop",2017,329,329,4,0,325,329,4
27477,"Bayou Coquille Trail",29.793816,-90.122452,1044,"eastern poison ivy","Plantae","Deciduous broadleaf",390,"Fruits","Ripe fruits",2017,325,329,15,16,310,345,35
27477,"Bayou Coquille Trail",29.793816,-90.122452,1044,"eastern poison ivy","Plantae","Deciduous broadleaf",471,"Leaves","Falling leaves",2017,325,329,15,16,310,345,35
27477,"Bayou Coquille Trail",29.793816,-90.122452,1044,"eastern poison ivy","Plantae","Deciduous broadleaf",483,"Leaves","Leaves",2017,325,329,15,16,310,345,35
27477,"Bayou Coquille Trail",29.793816,-90.122452,1044,"eastern poison ivy","Plantae","Deciduous broadleaf",498,"Leaves","Colored leaves",2017,329,329,4,16,325,345,20
27477,"Bayou Coquille Trail",29.793816,-90.122452,1044,"eastern poison ivy","Plantae","Deciduous broadleaf",516,"Fruits","Fruits",2017,325,329,15,16,310,345,35
27477,"Bayou Coquille Trail",29.793816,-90.122452,1045,"Chinese tallow","Plantae","Deciduous broadleaf",390,"Fruits","Ripe fruits",2017,301,329,5,26,296,355,59
27477,"Bayou Coquille Trail",29.793816,-90.122452,1045,"Chinese tallow","Plantae","Deciduous broadleaf",471,"Leaves","Falling leaves",2017,301,345,5,10,296,355,59
27477,"Bayou Coquille Trail",29.793816,-90.122452,1045,"Chinese tallow","Plantae","Deciduous broadleaf",483,"Leaves","Leaves",2017,345,345,0,10,345,355,10
27477,"Bayou Coquille Trail",29.793816,-90.122452,1045,"Chinese tallow","Plantae","Deciduous broadleaf",498,"Leaves","Colored leaves",2017,345,345,0,10,345,355,10
27477,"Bayou Coquille Trail",29.793816,-90.122452,1045,"Chinese tallow","Plantae","Deciduous broadleaf",516,"Fruits","Fruits",2017,325,329,3,26,322,355,33
27477,"Bayou Coquille Trail",29.793816,-90.122452,1605,"sugarberry","Plantae","Deciduous broadleaf",467,"Leaves","Increasing leaf size",2017,325,325,3,20,322,345,23
27477,"Bayou Coquille Trail",29.793816,-90.122452,1605,"sugarberry","Plantae","Deciduous broadleaf",498,"Leaves","Colored leaves",2017,301,301,5,0,296,301,5
27477,"Bayou Coquille Trail",29.793816,-90.122452,1605,"sugarberry","Plantae","Deciduous broadleaf",500,"Flowers","Flowers or flower buds",2017,325,325,3,4,322,329,7
27477,"Bayou Coquille Trail",29.793816,-90.122452,1616,"possumhaw","Plantae","Deciduous broadleaf",471,"Leaves","Falling leaves",2017,301,301,5,0,296,301,5
27477,"Bayou Coquille Trail",29.793816,-90.122452,1616,"possumhaw","Plantae","Deciduous broadleaf",498,"Leaves","Colored leaves",2017,301,301,5,0,296,301,5
27477,"Bayou Coquille Trail",29.793816,-90.122452,1616,"possumhaw","Plantae","Deciduous broadleaf",504,"Fruits","Recent fruit or seed drop",2017,301,301,5,21,296,322,26
27474,"Visitor Center Trail",29.784473,-90.114784,2,"boxelder","Plantae","Deciduous broadleaf",371,"Leaves","Breaking leaf buds",2018,81,86,7,10,74,96,22
27474,"Visitor Center Trail",29.784473,-90.114784,2,"boxelder","Plantae","Deciduous broadleaf",467,"Leaves","Increasing leaf size",2018,121,121,0,14,121,135,14
27474,"Visitor Center Trail",29.784473,-90.114784,2,"boxelder","Plantae","Deciduous broadleaf",471,"Leaves","Falling leaves",2018,284,284,28,0,256,284,28
27474,"Visitor Center Trail",29.784473,-90.114784,2,"boxelder","Plantae","Deciduous broadleaf",500,"Flowers","Flowers or flower buds",2018,86,86,5,10,81,96,15
27474,"Visitor Center Trail",29.784473,-90.114784,2,"boxelder","Plantae","Deciduous broadleaf",501,"Flowers","Open flowers",2018,60,86,1,10,59,96,37
27474,"Visitor Center Trail",29.784473,-90.114784,2,"boxelder","Plantae","Deciduous broadleaf",502,"Flowers","Pollen release (flowers)",2018,55,60,2,14,53,74,21
27474,"Visitor Center Trail",29.784473,-90.114784,2,"boxelder","Plantae","Deciduous broadleaf",516,"Fruits","Fruits",2018,60,60,1,14,59,74,15
27474,"Visitor Center Trail",29.784473,-90.114784,81,"sweetgum","Plantae","Deciduous broadleaf",371,"Leaves","Breaking leaf buds",2018,53,74,7,7,46,81,35
27474,"Visitor Center Trail",29.784473,-90.114784,81,"sweetgum","Plantae","Deciduous broadleaf",390,"Fruits","Ripe fruits",2018,59,116,4,5,55,121,66
27474,"Visitor Center Trail",29.784473,-90.114784,81,"sweetgum","Plantae","Deciduous broadleaf",467,"Leaves","Increasing leaf size",2018,55,121,2,14,53,135,82
27474,"Visitor Center Trail",29.784473,-90.114784,81,"sweetgum","Plantae","Deciduous broadleaf",471,"Leaves","Falling leaves",2018,242,242,21,14,221,256,35
27474,"Visitor Center Trail",29.784473,-90.114784,81,"sweetgum","Plantae","Deciduous broadleaf",483,"Leaves","Leaves",2018,55,55,2,0,53,55,2
27474,"Visitor Center Trail",29.784473,-90.114784,81,"sweetgum","Plantae","Deciduous broadleaf",500,"Flowers","Flowers or flower buds",2018,59,59,4,2,55,61,6
27474,"Visitor Center Trail",29.784473,-90.114784,81,"sweetgum","Plantae","Deciduous broadleaf",501,"Flowers","Open flowers",2018,59,59,4,2,55,61,6
27474,"Visitor Center Trail",29.784473,-90.114784,81,"sweetgum","Plantae","Deciduous broadleaf",504,"Fruits","Recent fruit or seed drop",2018,86,103,5,13,81,116,35
27474,"Visitor Center Trail",29.784473,-90.114784,81,"sweetgum","Plantae","Deciduous broadleaf",516,"Fruits","Fruits",2018,59,116,4,5,55,121,66
27474,"Visitor Center Trail",29.784473,-90.114784,201,"common buttonbush","Plantae","Deciduous broadleaf",371,"Leaves","Breaking leaf buds",2018,53,121,7,14,46,135,89
27474,"Visitor Center Trail",29.784473,-90.114784,201,"common buttonbush","Plantae","Deciduous broadleaf",390,"Fruits","Ripe fruits",2018,59,103,4,13,55,116,61
27474,"Visitor Center Trail",29.784473,-90.114784,201,"common buttonbush","Plantae","Deciduous broadleaf",467,"Leaves","Increasing leaf size",2018,55,135,2,24,53,159,106
27474,"Visitor Center Trail",29.784473,-90.114784,201,"common buttonbush","Plantae","Deciduous broadleaf",471,"Leaves","Falling leaves",2018,86,86,5,10,81,96,15
27474,"Visitor Center Trail",29.784473,-90.114784,201,"common buttonbush","Plantae","Deciduous broadleaf",483,"Leaves","Leaves",2018,55,256,2,28,53,284,231
27474,"Visitor Center Trail",29.784473,-90.114784,201,"common buttonbush","Plantae","Deciduous broadleaf",498,"Leaves","Colored leaves",2018,242,256,21,28,221,284,63
27474,"Visitor Center Trail",29.784473,-90.114784,201,"common buttonbush","Plantae","Deciduous broadleaf",500,"Flowers","Flowers or flower buds",2018,103,256,7,28,96,284,188
27474,"Visitor Center Trail",29.784473,-90.114784,201,"common buttonbush","Plantae","Deciduous broadleaf",501,"Flowers","Open flowers",2018,135,256,14,28,121,284,163
27474,"Visitor Center Trail",29.784473,-90.114784,201,"common buttonbush","Plantae","Deciduous broadleaf",504,"Fruits","Recent fruit or seed drop",2018,242,242,21,0,221,242,21
27474,"Visitor Center Trail",29.784473,-90.114784,201,"common buttonbush","Plantae","Deciduous broadleaf",516,"Fruits","Fruits",2018,59,103,4,13,55,116,61
27474,"Visitor Center Trail",29.784473,-90.114784,208,"white crownbeard","Plantae","Forb",482,"Leaves","Initial growth (forbs)",2018,86,103,5,13,81,116,35
27474,"Visitor Center Trail",29.784473,-90.114784,208,"white crownbeard","Plantae","Forb",500,"Flowers","Flowers or flower buds",2018,242,242,21,0,221,242,21
27474,"Visitor Center Trail",29.784473,-90.114784,208,"white crownbeard","Plantae","Forb",501,"Flowers","Open flowers",2018,284,284,28,0,256,284,28
27474,"Visitor Center Trail",29.784473,-90.114784,309,"trumpet creeper","Plantae","Deciduous broadleaf",371,"Leaves","Breaking leaf buds",2018,53,246,7,10,46,256,210
27474,"Visitor Center Trail",29.784473,-90.114784,309,"trumpet creeper","Plantae","Deciduous broadleaf",467,"Leaves","Increasing leaf size",2018,53,323,7,4,46,327,281
27474,"Visitor Center Trail",29.784473,-90.114784,309,"trumpet creeper","Plantae","Deciduous broadleaf",483,"Leaves","Leaves",2018,53,256,7,28,46,284,238
27474,"Visitor Center Trail",29.784473,-90.114784,309,"trumpet creeper","Plantae","Deciduous broadleaf",498,"Leaves","Colored leaves",2018,256,256,14,0,242,256,14
27474,"Visitor Center Trail",29.784473,-90.114784,309,"trumpet creeper","Plantae","Deciduous broadleaf",500,"Flowers","Flowers or flower buds",2018,135,242,14,4,121,246,125
27474,"Visitor Center Trail",29.784473,-90.114784,309,"trumpet creeper","Plantae","Deciduous broadleaf",501,"Flowers","Open flowers",2018,159,256,24,28,135,284,149
27474,"Visitor Center Trail",29.784473,-90.114784,309,"trumpet creeper","Plantae","Deciduous broadleaf",516,"Fruits","Fruits",2018,284,284,28,0,256,284,28
27474,"Visitor Center Trail",29.784473,-90.114784,722,"wax myrtle","Plantae","Evergreen broadleaf",371,"Leaves","Breaking leaf buds",2018,55,121,2,14,53,135,82
27474,"Visitor Center Trail",29.784473,-90.114784,722,"wax myrtle","Plantae","Evergreen broadleaf",484,"Leaves","Young leaves (tree/shrub)",2018,53,256,7,28,46,284,238
27474,"Visitor Center Trail",29.784473,-90.114784,722,"wax myrtle","Plantae","Evergreen broadleaf",500,"Flowers","Flowers or flower buds",2018,103,116,7,5,96,121,25
27474,"Visitor Center Trail",29.784473,-90.114784,722,"wax myrtle","Plantae","Evergreen broadleaf",501,"Flowers","Open flowers",2018,53,116,7,5,46,121,75
27474,"Visitor Center Trail",29.784473,-90.114784,722,"wax myrtle","Plantae","Evergreen broadleaf",504,"Fruits","Recent fruit or seed drop",2018,284,284,28,0,256,284,28
27474,"Visitor Center Trail",29.784473,-90.114784,722,"wax myrtle","Plantae","Evergreen broadleaf",516,"Fruits","Fruits",2018,135,135,14,0,121,135,14
27474,"Visitor Center Trail",29.784473,-90.114784,804,"eastern baccharis","Plantae","Deciduous broadleaf",371,"Leaves","Breaking leaf buds",2018,103,121,7,14,96,135,39
27474,"Visitor Center Trail",29.784473,-90.114784,804,"eastern baccharis","Plantae","Deciduous broadleaf",471,"Leaves","Falling leaves",2018,261,261,5,0,256,261,5
27474,"Visitor Center Trail",29.784473,-90.114784,804,"eastern baccharis","Plantae","Deciduous broadleaf",500,"Flowers","Flowers or flower buds",2018,242,242,21,0,221,242,21
27474,"Visitor Center Trail",29.784473,-90.114784,804,"eastern baccharis","Plantae","Deciduous broadleaf",501,"Flowers","Open flowers",2018,261,261,5,0,256,261,5
27475,"Palmetto Trail",29.783813,-90.117561,3,"red maple","Plantae","Deciduous broadleaf",371,"Leaves","Breaking leaf buds",2018,55,81,10,15,45,96,51
27475,"Palmetto Trail",29.783813,-90.117561,3,"red maple","Plantae","Deciduous broadleaf",467,"Leaves","Increasing leaf size",2018,55,96,10,20,45,116,71
27475,"Palmetto Trail",29.783813,-90.117561,3,"red maple","Plantae","Deciduous broadleaf",483,"Leaves","Leaves",2018,55,60,10,1,45,61,16
27475,"Palmetto Trail",29.783813,-90.117561,3,"red maple","Plantae","Deciduous broadleaf",498,"Leaves","Colored leaves",2018,246,246,4,10,242,256,14
27475,"Palmetto Trail",29.783813,-90.117561,3,"red maple","Plantae","Deciduous broadleaf",500,"Flowers","Flowers or flower buds",2018,45,45,0,10,45,55,10
27475,"Palmetto Trail",29.783813,-90.117561,3,"red maple","Plantae","Deciduous broadleaf",501,"Flowers","Open flowers",2018,45,45,0,10,45,55,10
27475,"Palmetto Trail",29.783813,-90.117561,3,"red maple","Plantae","Deciduous broadleaf",504,"Fruits","Recent fruit or seed drop",2018,61,61,1,13,60,74,14
27475,"Palmetto Trail",29.783813,-90.117561,3,"red maple","Plantae","Deciduous broadleaf",516,"Fruits","Fruits",2018,61,61,1,13,60,74,14
27475,"Palmetto Trail",29.783813,-90.117561,81,"sweetgum","Plantae","Deciduous broadleaf",371,"Leaves","Breaking leaf buds",2018,61,61,0,7,61,68,7
27475,"Palmetto Trail",29.783813,-90.117561,81,"sweetgum","Plantae","Deciduous broadleaf",390,"Fruits","Ripe fruits",2018,61,249,1,20,60,269,209
27475,"Palmetto Trail",29.783813,-90.117561,81,"sweetgum","Plantae","Deciduous broadleaf",467,"Leaves","Increasing leaf size",2018,55,116,10,19,45,135,90
27475,"Palmetto Trail",29.783813,-90.117561,81,"sweetgum","Plantae","Deciduous broadleaf",483,"Leaves","Leaves",2018,55,55,10,0,45,55,10
27475,"Palmetto Trail",29.783813,-90.117561,81,"sweetgum","Plantae","Deciduous broadleaf",498,"Leaves","Colored leaves",2018,262,262,23.5,0,238.5,262,23.5
27475,"Palmetto Trail",29.783813,-90.117561,81,"sweetgum","Plantae","Deciduous broadleaf",500,"Flowers","Flowers or flower buds",2018,60,60,5,1,55,61,6
27475,"Palmetto Trail",29.783813,-90.117561,81,"sweetgum","Plantae","Deciduous broadleaf",501,"Flowers","Open flowers",2018,60,60,5,1,55,61,6
27475,"Palmetto Trail",29.783813,-90.117561,81,"sweetgum","Plantae","Deciduous broadleaf",504,"Fruits","Recent fruit or seed drop",2018,45,45,0,10,45,55,10
27475,"Palmetto Trail",29.783813,-90.117561,81,"sweetgum","Plantae","Deciduous broadleaf",516,"Fruits","Fruits",2018,60,151,5,18,55,169,114
27475,"Palmetto Trail",29.783813,-90.117561,296,"bald cypress","Plantae","Deciduous conifer",392,"Seed cones","Unripe seed cones",2018,169,242,8.5,4,160.5,246,85.5
27475,"Palmetto Trail",29.783813,-90.117561,296,"bald cypress","Plantae","Deciduous conifer",393,"Seed cones","Ripe seed cones",2018,135,256,19,26,116,282,166
27475,"Palmetto Trail",29.783813,-90.117561,296,"bald cypress","Plantae","Deciduous conifer",472,"Needles","Falling needles",2018,246,246,4,10,242,256,14
27475,"Palmetto Trail",29.783813,-90.117561,296,"bald cypress","Plantae","Deciduous conifer",481,"Needles","Breaking needle buds (deciduous)",2018,60,81,15,15,45,96,51
27475,"Palmetto Trail",29.783813,-90.117561,296,"bald cypress","Plantae","Deciduous conifer",487,"Needles","Needles (deciduous)",2018,55,55,10,0,45,55,10
27475,"Palmetto Trail",29.783813,-90.117561,296,"bald cypress","Plantae","Deciduous conifer",490,"Pollen cones","Pollen cones (conifers)",2018,74,74,14,7,60,81,21
27475,"Palmetto Trail",29.783813,-90.117561,296,"bald cypress","Plantae","Deciduous conifer",491,"Seed cones","Recent cone or seed drop",2018,242,246,21,10,221,256,35
27475,"Palmetto Trail",29.783813,-90.117561,296,"bald cypress","Plantae","Deciduous conifer",495,"Pollen cones","Open pollen cones (conifers)",2018,45,45,0,10,45,55,10
27475,"Palmetto Trail",29.783813,-90.117561,296,"bald cypress","Plantae","Deciduous conifer",499,"Needles","Colored needles",2018,246,246,4,10,242,256,14
27475,"Palmetto Trail",29.783813,-90.117561,296,"bald cypress","Plantae","Deciduous conifer",503,"Pollen cones","Pollen release (conifers)",2018,81,81,7,15,74,96,22
27475,"Palmetto Trail",29.783813,-90.117561,305,"live oak","Plantae","Semi-evergreen broadleaf",371,"Leaves","Breaking leaf buds",2018,55,81,10,15,45,96,51
27475,"Palmetto Trail",29.783813,-90.117561,305,"live oak","Plantae","Semi-evergreen broadleaf",390,"Fruits","Ripe fruits",2018,159,159,24,20,135,179,44
27475,"Palmetto Trail",29.783813,-90.117561,305,"live oak","Plantae","Semi-evergreen broadleaf",467,"Leaves","Increasing leaf size",2018,55,116,10,19,45,135,90
27475,"Palmetto Trail",29.783813,-90.117561,305,"live oak","Plantae","Semi-evergreen broadleaf",471,"Leaves","Falling leaves",2018,55,55,0,5,55,60,5
27475,"Palmetto Trail",29.783813,-90.117561,305,"live oak","Plantae","Semi-evergreen broadleaf",484,"Leaves","Young leaves (tree/shrub)",2018,55,116,10,19,45,135,90
27475,"Palmetto Trail",29.783813,-90.117561,305,"live oak","Plantae","Semi-evergreen broadleaf",500,"Flowers","Flowers or flower buds",2018,55,74,10,7,45,81,36
27475,"Palmetto Trail",29.783813,-90.117561,305,"live oak","Plantae","Semi-evergreen broadleaf",501,"Flowers","Open flowers",2018,55,81,10,15,45,96,51
27475,"Palmetto Trail",29.783813,-90.117561,305,"live oak","Plantae","Semi-evergreen broadleaf",502,"Flowers","Pollen release (flowers)",2018,55,81,10,15,45,96,51
27475,"Palmetto Trail",29.783813,-90.117561,305,"live oak","Plantae","Semi-evergreen broadleaf",516,"Fruits","Fruits",2018,135,135,19,24,116,159,43
27475,"Palmetto Trail",29.783813,-90.117561,309,"trumpet creeper","Plantae","Deciduous broadleaf",371,"Leaves","Breaking leaf buds",2018,74,116,13,19,61,135,74
27475,"Palmetto Trail",29.783813,-90.117561,309,"trumpet creeper","Plantae","Deciduous broadleaf",467,"Leaves","Increasing leaf size",2018,74,116,13,19,61,135,74
27475,"Palmetto Trail",29.783813,-90.117561,309,"trumpet creeper","Plantae","Deciduous broadleaf",471,"Leaves","Falling leaves",2018,282,282,26,0,256,282,26
27475,"Palmetto Trail",29.783813,-90.117561,309,"trumpet creeper","Plantae","Deciduous broadleaf",483,"Leaves","Leaves",2018,74,74,13,0,61,74,13
27475,"Palmetto Trail",29.783813,-90.117561,309,"trumpet creeper","Plantae","Deciduous broadleaf",498,"Leaves","Colored leaves",2018,282,282,26,0,256,282,26
27475,"Palmetto Trail",29.783813,-90.117561,309,"trumpet creeper","Plantae","Deciduous broadleaf",500,"Flowers","Flowers or flower buds",2018,159,159,24,0,135,159,24
27475,"Palmetto Trail",29.783813,-90.117561,309,"trumpet creeper","Plantae","Deciduous broadleaf",501,"Flowers","Open flowers",2018,159,159,24,0,135,159,24
27475,"Palmetto Trail",29.783813,-90.117561,804,"eastern baccharis","Plantae","Deciduous broadleaf",371,"Leaves","Breaking leaf buds",2018,55,60,10,1,45,61,16
27475,"Palmetto Trail",29.783813,-90.117561,804,"eastern baccharis","Plantae","Deciduous broadleaf",471,"Leaves","Falling leaves",2018,282,282,26,0,256,282,26
27475,"Palmetto Trail",29.783813,-90.117561,804,"eastern baccharis","Plantae","Deciduous broadleaf",500,"Flowers","Flowers or flower buds",2018,242,308,21,19,221,327,106
27475,"Palmetto Trail",29.783813,-90.117561,804,"eastern baccharis","Plantae","Deciduous broadleaf",501,"Flowers","Open flowers",2018,282,308,21,19,261,327,66
27475,"Palmetto Trail",29.783813,-90.117561,804,"eastern baccharis","Plantae","Deciduous broadleaf",502,"Flowers","Pollen release (flowers)",2018,282,282,21,26,261,308,47
27475,"Palmetto Trail",29.783813,-90.117561,804,"eastern baccharis","Plantae","Deciduous broadleaf",516,"Fruits","Fruits",2018,308,308,26,19,282,327,45
27475,"Palmetto Trail",29.783813,-90.117561,940,"water tupelo ","Plantae","Deciduous broadleaf",371,"Leaves","Breaking leaf buds",2018,55,81,10,15,45,96,51
27475,"Palmetto Trail",29.783813,-90.117561,940,"water tupelo ","Plantae","Deciduous broadleaf",467,"Leaves","Increasing leaf size",2018,81,96,7,20,74,116,42
27475,"Palmetto Trail",29.783813,-90.117561,940,"water tupelo ","Plantae","Deciduous broadleaf",471,"Leaves","Falling leaves",2018,45,45,0,10,45,55,10
27475,"Palmetto Trail",29.783813,-90.117561,940,"water tupelo ","Plantae","Deciduous broadleaf",483,"Leaves","Leaves",2018,81,81,7,0,74,81,7
27475,"Palmetto Trail",29.783813,-90.117561,940,"water tupelo ","Plantae","Deciduous broadleaf",500,"Flowers","Flowers or flower buds",2018,81,96,7,20,74,116,42
27475,"Palmetto Trail",29.783813,-90.117561,940,"water tupelo ","Plantae","Deciduous broadleaf",501,"Flowers","Open flowers",2018,81,96,7,20,74,116,42
27475,"Palmetto Trail",29.783813,-90.117561,940,"water tupelo ","Plantae","Deciduous broadleaf",504,"Fruits","Recent fruit or seed drop",2018,256,256,10,5,246,261,15
27475,"Palmetto Trail",29.783813,-90.117561,940,"water tupelo ","Plantae","Deciduous broadleaf",516,"Fruits","Fruits",2018,96,96,15,20,81,116,35
27475,"Palmetto Trail",29.783813,-90.117561,1044,"eastern poison ivy","Plantae","Deciduous broadleaf",371,"Leaves","Breaking leaf buds",2018,74,81,13,15,61,96,35
27475,"Palmetto Trail",29.783813,-90.117561,1044,"eastern poison ivy","Plantae","Deciduous broadleaf",390,"Fruits","Ripe fruits",2018,256,256,14,0,242,256,14
27475,"Palmetto Trail",29.783813,-90.117561,1044,"eastern poison ivy","Plantae","Deciduous broadleaf",467,"Leaves","Increasing leaf size",2018,61,96,1,20,60,116,56
27475,"Palmetto Trail",29.783813,-90.117561,1044,"eastern poison ivy","Plantae","Deciduous broadleaf",483,"Leaves","Leaves",2018,61,61,1,0,60,61,1
27475,"Palmetto Trail",29.783813,-90.117561,1044,"eastern poison ivy","Plantae","Deciduous broadleaf",498,"Leaves","Colored leaves",2018,242,242,21,0,221,242,21
27475,"Palmetto Trail",29.783813,-90.117561,1044,"eastern poison ivy","Plantae","Deciduous broadleaf",500,"Flowers","Flowers or flower buds",2018,116,116,20,19,96,135,39
27475,"Palmetto Trail",29.783813,-90.117561,1044,"eastern poison ivy","Plantae","Deciduous broadleaf",501,"Flowers","Open flowers",2018,116,116,20,19,96,135,39
27475,"Palmetto Trail",29.783813,-90.117561,1044,"eastern poison ivy","Plantae","Deciduous broadleaf",502,"Flowers","Pollen release (flowers)",2018,116,116,20,19,96,135,39
27475,"Palmetto Trail",29.783813,-90.117561,1044,"eastern poison ivy","Plantae","Deciduous broadleaf",516,"Fruits","Fruits",2018,96,96,15,20,81,116,35
27475,"Palmetto Trail",29.783813,-90.117561,1045,"Chinese tallow","Plantae","Deciduous broadleaf",467,"Leaves","Increasing leaf size",2018,242,242,0,14,242,256,14
27475,"Palmetto Trail",29.783813,-90.117561,1045,"Chinese tallow","Plantae","Deciduous broadleaf",471,"Leaves","Falling leaves",2018,242,242,0,14,242,256,14
27475,"Palmetto Trail",29.783813,-90.117561,1045,"Chinese tallow","Plantae","Deciduous broadleaf",498,"Leaves","Colored leaves",2018,242,242,0,14,242,256,14
27475,"Palmetto Trail",29.783813,-90.117561,1616,"possumhaw","Plantae","Deciduous broadleaf",371,"Leaves","Breaking leaf buds",2018,55,68,10,10,45,78,33
27475,"Palmetto Trail",29.783813,-90.117561,1616,"possumhaw","Plantae","Deciduous broadleaf",390,"Fruits","Ripe fruits",2018,282,282,21,0,261,282,21
27475,"Palmetto Trail",29.783813,-90.117561,1616,"possumhaw","Plantae","Deciduous broadleaf",467,"Leaves","Increasing leaf size",2018,55,182,10,20.5,45,202.5,157.5
27475,"Palmetto Trail",29.783813,-90.117561,1616,"possumhaw","Plantae","Deciduous broadleaf",471,"Leaves","Falling leaves",2018,242,308,21,19,221,327,106
27475,"Palmetto Trail",29.783813,-90.117561,1616,"possumhaw","Plantae","Deciduous broadleaf",483,"Leaves","Leaves",2018,55,55,10,0,45,55,10
27475,"Palmetto Trail",29.783813,-90.117561,1616,"possumhaw","Plantae","Deciduous broadleaf",498,"Leaves","Colored leaves",2018,308,308,0,19,308,327,19
27475,"Palmetto Trail",29.783813,-90.117561,1616,"possumhaw","Plantae","Deciduous broadleaf",500,"Flowers","Flowers or flower buds",2018,61,71,1,14,60,85,25
27475,"Palmetto Trail",29.783813,-90.117561,1616,"possumhaw","Plantae","Deciduous broadleaf",501,"Flowers","Open flowers",2018,71,81,6,15,65,96,31
27475,"Palmetto Trail",29.783813,-90.117561,1616,"possumhaw","Plantae","Deciduous broadleaf",504,"Fruits","Recent fruit or seed drop",2018,261,261,19,0,242,261,19
27475,"Palmetto Trail",29.783813,-90.117561,1616,"possumhaw","Plantae","Deciduous broadleaf",516,"Fruits","Fruits",2018,78,78,10,0,68,78,10
27476,"Ring Levee Trail",29.785265,-90.110191,2,"boxelder","Plantae","Deciduous broadleaf",371,"Leaves","Breaking leaf buds",2018,54,54,22,28,32,82,50
27476,"Ring Levee Trail",29.785265,-90.110191,2,"boxelder","Plantae","Deciduous broadleaf",467,"Leaves","Increasing leaf size",2018,54,102,22,7,32,109,77
27476,"Ring Levee Trail",29.785265,-90.110191,2,"boxelder","Plantae","Deciduous broadleaf",471,"Leaves","Falling leaves",2018,312,312,28,21,284,333,49
27476,"Ring Levee Trail",29.785265,-90.110191,2,"boxelder","Plantae","Deciduous broadleaf",483,"Leaves","Leaves",2018,54,333,22,21,32,354,322
27476,"Ring Levee Trail",29.785265,-90.110191,2,"boxelder","Plantae","Deciduous broadleaf",498,"Leaves","Colored leaves",2018,333,333,0,21,333,354,21
27476,"Ring Levee Trail",29.785265,-90.110191,2,"boxelder","Plantae","Deciduous broadleaf",500,"Flowers","Flowers or flower buds",2018,54,54,22,28,32,82,50
27476,"Ring Levee Trail",29.785265,-90.110191,2,"boxelder","Plantae","Deciduous broadleaf",501,"Flowers","Open flowers",2018,54,54,22,28,32,82,50
27476,"Ring Levee Trail",29.785265,-90.110191,3,"red maple","Plantae","Deciduous broadleaf",371,"Leaves","Breaking leaf buds",2018,54,82,15,5,39,87,48
27476,"Ring Levee Trail",29.785265,-90.110191,3,"red maple","Plantae","Deciduous broadleaf",390,"Fruits","Ripe fruits",2018,54,54,15,7,39,61,22
27476,"Ring Levee Trail",29.785265,-90.110191,3,"red maple","Plantae","Deciduous broadleaf",467,"Leaves","Increasing leaf size",2018,54,109,15,12,39,121,82
27476,"Ring Levee Trail",29.785265,-90.110191,3,"red maple","Plantae","Deciduous broadleaf",471,"Leaves","Falling leaves",2018,284,333,12,21,272,354,82
27476,"Ring Levee Trail",29.785265,-90.110191,3,"red maple","Plantae","Deciduous broadleaf",483,"Leaves","Leaves",2018,54,111,15,10,39,121,82
27476,"Ring Levee Trail",29.785265,-90.110191,3,"red maple","Plantae","Deciduous broadleaf",498,"Leaves","Colored leaves",2018,82,333,21,21,61,354,293
27476,"Ring Levee Trail",29.785265,-90.110191,3,"red maple","Plantae","Deciduous broadleaf",500,"Flowers","Flowers or flower buds",2018,32,39,7,15,25,54,29
27476,"Ring Levee Trail",29.785265,-90.110191,3,"red maple","Plantae","Deciduous broadleaf",501,"Flowers","Open flowers",2018,32,39,7,15,25,54,29
27476,"Ring Levee Trail",29.785265,-90.110191,3,"red maple","Plantae","Deciduous broadleaf",502,"Flowers","Pollen release (flowers)",2018,39,111,14,10,25,121,96
27476,"Ring Levee Trail",29.785265,-90.110191,3,"red maple","Plantae","Deciduous broadleaf",516,"Fruits","Fruits",2018,54,54,15,7,39,61,22
27476,"Ring Levee Trail",29.785265,-90.110191,81,"sweetgum","Plantae","Deciduous broadleaf",371,"Leaves","Breaking leaf buds",2018,25,25,0,4,25,29,4
27476,"Ring Levee Trail",29.785265,-90.110191,81,"sweetgum","Plantae","Deciduous broadleaf",390,"Fruits","Ripe fruits",2018,29,82,4,5,25,87,62
27476,"Ring Levee Trail",29.785265,-90.110191,81,"sweetgum","Plantae","Deciduous broadleaf",467,"Leaves","Increasing leaf size",2018,102,102,0,7,102,109,7
27476,"Ring Levee Trail",29.785265,-90.110191,81,"sweetgum","Plantae","Deciduous broadleaf",471,"Leaves","Falling leaves",2018,29,272,4,12,25,284,259
27476,"Ring Levee Trail",29.785265,-90.110191,81,"sweetgum","Plantae","Deciduous broadleaf",483,"Leaves","Leaves",2018,29,109,4,12,25,121,96
27476,"Ring Levee Trail",29.785265,-90.110191,81,"sweetgum","Plantae","Deciduous broadleaf",504,"Fruits","Recent fruit or seed drop",2018,29,333,4,21,25,354,329
27476,"Ring Levee Trail",29.785265,-90.110191,81,"sweetgum","Plantae","Deciduous broadleaf",516,"Fruits","Fruits",2018,29,109,4,12,25,121,96
27476,"Ring Levee Trail",29.785265,-90.110191,296,"bald cypress","Plantae","Deciduous conifer",392,"Seed cones","Unripe seed cones",2018,87,87,5,0,82,87,5
27476,"Ring Levee Trail",29.785265,-90.110191,296,"bald cypress","Plantae","Deciduous conifer",393,"Seed cones","Ripe seed cones",2018,82,144,21,21,61,165,104
27476,"Ring Levee Trail",29.785265,-90.110191,296,"bald cypress","Plantae","Deciduous conifer",472,"Needles","Falling needles",2018,29,61,4,21,25,82,57
27476,"Ring Levee Trail",29.785265,-90.110191,296,"bald cypress","Plantae","Deciduous conifer",481,"Needles","Breaking needle buds (deciduous)",2018,54,82,15,5,39,87,48
27476,"Ring Levee Trail",29.785265,-90.110191,296,"bald cypress","Plantae","Deciduous conifer",487,"Needles","Needles (deciduous)",2018,29,29,4,3,25,32,7
27476,"Ring Levee Trail",29.785265,-90.110191,296,"bald cypress","Plantae","Deciduous conifer",490,"Pollen cones","Pollen cones (conifers)",2018,82,284,21,28,61,312,251
27476,"Ring Levee Trail",29.785265,-90.110191,296,"bald cypress","Plantae","Deciduous conifer",495,"Pollen cones","Open pollen cones (conifers)",2018,82,284,21,28,61,312,251
27476,"Ring Levee Trail",29.785265,-90.110191,296,"bald cypress","Plantae","Deciduous conifer",499,"Needles","Colored needles",2018,29,121,4,2,25,123,98
27476,"Ring Levee Trail",29.785265,-90.110191,296,"bald cypress","Plantae","Deciduous conifer",503,"Pollen cones","Pollen release (conifers)",2018,32,39,3,22,29,61,32
27476,"Ring Levee Trail",29.785265,-90.110191,305,"live oak","Plantae","Semi-evergreen broadleaf",371,"Leaves","Breaking leaf buds",2018,82,82,28,5,54,87,33
27476,"Ring Levee Trail",29.785265,-90.110191,305,"live oak","Plantae","Semi-evergreen broadleaf",390,"Fruits","Ripe fruits",2018,312,312,28,21,284,333,49
27476,"Ring Levee Trail",29.785265,-90.110191,305,"live oak","Plantae","Semi-evergreen broadleaf",467,"Leaves","Increasing leaf size",2018,82,87,28,15,54,102,48
27476,"Ring Levee Trail",29.785265,-90.110191,305,"live oak","Plantae","Semi-evergreen broadleaf",471,"Leaves","Falling leaves",2018,29,82,4,5,25,87,62
27476,"Ring Levee Trail",29.785265,-90.110191,305,"live oak","Plantae","Semi-evergreen broadleaf",484,"Leaves","Young leaves (tree/shrub)",2018,61,87,7,15,54,102,48
27476,"Ring Levee Trail",29.785265,-90.110191,305,"live oak","Plantae","Semi-evergreen broadleaf",498,"Leaves","Colored leaves",2018,54,54,15,7,39,61,22
27476,"Ring Levee Trail",29.785265,-90.110191,305,"live oak","Plantae","Semi-evergreen broadleaf",500,"Flowers","Flowers or flower buds",2018,54,82,15,5,39,87,48
27476,"Ring Levee Trail",29.785265,-90.110191,305,"live oak","Plantae","Semi-evergreen broadleaf",501,"Flowers","Open flowers",2018,54,82,15,5,39,87,48
27476,"Ring Levee Trail",29.785265,-90.110191,305,"live oak","Plantae","Semi-evergreen broadleaf",502,"Flowers","Pollen release (flowers)",2018,82,82,21,5,61,87,26
27476,"Ring Levee Trail",29.785265,-90.110191,305,"live oak","Plantae","Semi-evergreen broadleaf",504,"Fruits","Recent fruit or seed drop",2018,333,333,0,21,333,354,21
27476,"Ring Levee Trail",29.785265,-90.110191,305,"live oak","Plantae","Semi-evergreen broadleaf",516,"Fruits","Fruits",2018,82,312,21,21,61,333,272
27476,"Ring Levee Trail",29.785265,-90.110191,309,"trumpet creeper","Plantae","Deciduous broadleaf",371,"Leaves","Breaking leaf buds",2018,54,121,15,2,39,123,84
27476,"Ring Levee Trail",29.785265,-90.110191,309,"trumpet creeper","Plantae","Deciduous broadleaf",467,"Leaves","Increasing leaf size",2018,61,284,7,28,54,312,258
27476,"Ring Levee Trail",29.785265,-90.110191,309,"trumpet creeper","Plantae","Deciduous broadleaf",471,"Leaves","Falling leaves",2018,312,312,0,21,312,333,21
27476,"Ring Levee Trail",29.785265,-90.110191,309,"trumpet creeper","Plantae","Deciduous broadleaf",483,"Leaves","Leaves",2018,54,333,15,21,39,354,315
27476,"Ring Levee Trail",29.785265,-90.110191,309,"trumpet creeper","Plantae","Deciduous broadleaf",498,"Leaves","Colored leaves",2018,333,333,0,21,333,354,21
27476,"Ring Levee Trail",29.785265,-90.110191,309,"trumpet creeper","Plantae","Deciduous broadleaf",500,"Flowers","Flowers or flower buds",2018,144,144,21,0,123,144,21
27476,"Ring Levee Trail",29.785265,-90.110191,722,"wax myrtle","Plantae","Evergreen broadleaf",371,"Leaves","Breaking leaf buds",2018,32,82,7,20,25,102,77
27476,"Ring Levee Trail",29.785265,-90.110191,722,"wax myrtle","Plantae","Evergreen broadleaf",484,"Leaves","Young leaves (tree/shrub)",2018,54,272,15,12,39,284,245
27476,"Ring Levee Trail",29.785265,-90.110191,722,"wax myrtle","Plantae","Evergreen broadleaf",504,"Fruits","Recent fruit or seed drop",2018,312,312,28,0,284,312,28
27476,"Ring Levee Trail",29.785265,-90.110191,812,"American beautyberry","Plantae","Deciduous broadleaf",371,"Leaves","Breaking leaf buds",2018,39,123,7,21,32,144,112
27476,"Ring Levee Trail",29.785265,-90.110191,812,"American beautyberry","Plantae","Deciduous broadleaf",390,"Fruits","Ripe fruits",2018,29,333,4,21,25,354,329
27476,"Ring Levee Trail",29.785265,-90.110191,812,"American beautyberry","Plantae","Deciduous broadleaf",467,"Leaves","Increasing leaf size",2018,61,144,7,21,54,165,111
27476,"Ring Levee Trail",29.785265,-90.110191,812,"American beautyberry","Plantae","Deciduous broadleaf",483,"Leaves","Leaves",2018,61,333,7,21,54,354,300
27476,"Ring Levee Trail",29.785265,-90.110191,812,"American beautyberry","Plantae","Deciduous broadleaf",500,"Flowers","Flowers or flower buds",2018,61,165,7,21,54,186,132
27476,"Ring Levee Trail",29.785265,-90.110191,812,"American beautyberry","Plantae","Deciduous broadleaf",501,"Flowers","Open flowers",2018,61,165,7,21,54,186,132
27476,"Ring Levee Trail",29.785265,-90.110191,812,"American beautyberry","Plantae","Deciduous broadleaf",504,"Fruits","Recent fruit or seed drop",2018,333,333,0,21,333,354,21
27476,"Ring Levee Trail",29.785265,-90.110191,812,"American beautyberry","Plantae","Deciduous broadleaf",516,"Fruits","Fruits",2018,29,333,4,21,25,354,329
27476,"Ring Levee Trail",29.785265,-90.110191,885,"honeylocust","Plantae","Deciduous broadleaf",371,"Leaves","Breaking leaf buds",2018,82,111,21,10,61,121,60
27476,"Ring Levee Trail",29.785265,-90.110191,885,"honeylocust","Plantae","Deciduous broadleaf",467,"Leaves","Increasing leaf size",2018,82,123,21,21,61,144,83
27476,"Ring Levee Trail",29.785265,-90.110191,885,"honeylocust","Plantae","Deciduous broadleaf",471,"Leaves","Falling leaves",2018,284,312,12,21,272,333,61
27476,"Ring Levee Trail",29.785265,-90.110191,885,"honeylocust","Plantae","Deciduous broadleaf",483,"Leaves","Leaves",2018,82,333,21,21,61,354,293
27476,"Ring Levee Trail",29.785265,-90.110191,885,"honeylocust","Plantae","Deciduous broadleaf",498,"Leaves","Colored leaves",2018,312,312,28,21,284,333,49
27476,"Ring Levee Trail",29.785265,-90.110191,885,"honeylocust","Plantae","Deciduous broadleaf",500,"Flowers","Flowers or flower buds",2018,87,109,5,12,82,121,39
27476,"Ring Levee Trail",29.785265,-90.110191,885,"honeylocust","Plantae","Deciduous broadleaf",501,"Flowers","Open flowers",2018,109,123,7,21,102,144,42
27476,"Ring Levee Trail",29.785265,-90.110191,885,"honeylocust","Plantae","Deciduous broadleaf",516,"Fruits","Fruits",2018,123,272,2,12,121,284,163
27476,"Ring Levee Trail",29.785265,-90.110191,1044,"eastern poison ivy","Plantae","Deciduous broadleaf",371,"Leaves","Breaking leaf buds",2018,61,121,7,2,54,123,69
27476,"Ring Levee Trail",29.785265,-90.110191,1044,"eastern poison ivy","Plantae","Deciduous broadleaf",467,"Leaves","Increasing leaf size",2018,61,121,7,2,54,123,69
27476,"Ring Levee Trail",29.785265,-90.110191,1044,"eastern poison ivy","Plantae","Deciduous broadleaf",471,"Leaves","Falling leaves",2018,333,333,0,21,333,354,21
27476,"Ring Levee Trail",29.785265,-90.110191,1044,"eastern poison ivy","Plantae","Deciduous broadleaf",483,"Leaves","Leaves",2018,61,333,7,21,54,354,300
27476,"Ring Levee Trail",29.785265,-90.110191,1044,"eastern poison ivy","Plantae","Deciduous broadleaf",498,"Leaves","Colored leaves",2018,333,333,0,21,333,354,21
27476,"Ring Levee Trail",29.785265,-90.110191,1044,"eastern poison ivy","Plantae","Deciduous broadleaf",500,"Flowers","Flowers or flower buds",2018,102,121,15,2,87,123,36
27476,"Ring Levee Trail",29.785265,-90.110191,1044,"eastern poison ivy","Plantae","Deciduous broadleaf",501,"Flowers","Open flowers",2018,102,121,15,2,87,123,36
27476,"Ring Levee Trail",29.785265,-90.110191,1044,"eastern poison ivy","Plantae","Deciduous broadleaf",502,"Flowers","Pollen release (flowers)",2018,109,121,7,2,102,123,21
27476,"Ring Levee Trail",29.785265,-90.110191,1044,"eastern poison ivy","Plantae","Deciduous broadleaf",504,"Fruits","Recent fruit or seed drop",2018,144,284,21,28,123,312,189
27476,"Ring Levee Trail",29.785265,-90.110191,1044,"eastern poison ivy","Plantae","Deciduous broadleaf",516,"Fruits","Fruits",2018,82,87,21,15,61,102,41
27476,"Ring Levee Trail",29.785265,-90.110191,1126,"Carolina wren","Animalia","Bird",292,"Activity","Active individuals",2018,123,123,2,0,121,123,2
27476,"Ring Levee Trail",29.785265,-90.110191,1126,"Carolina wren","Animalia","Bird",293,"Activity","Calls or song (birds)",2018,121,121,0,2,121,123,2
27476,"Ring Levee Trail",29.785265,-90.110191,1126,"Carolina wren","Animalia","Bird",310,"Activity","Fruit/seed consumption",2018,123,123,2,0,121,123,2
27476,"Ring Levee Trail",29.785265,-90.110191,1126,"Carolina wren","Animalia","Bird",457,"Activity","Insect consumption",2018,123,123,2,0,121,123,2
27476,"Ring Levee Trail",29.785265,-90.110191,1126,"Carolina wren","Animalia","Bird",542,"Activity","Feeding (or foraging)",2018,123,123,2,0,121,123,2
27476,"Ring Levee Trail",29.785265,-90.110191,1230,"northern parula","Animalia","Bird",292,"Activity","Active individuals",2018,123,123,2,0,121,123,2
27476,"Ring Levee Trail",29.785265,-90.110191,1230,"northern parula","Animalia","Bird",293,"Activity","Calls or song (birds)",2018,123,123,2,0,121,123,2
27476,"Ring Levee Trail",29.785265,-90.110191,1230,"northern parula","Animalia","Bird",294,"Activity","Singing individuals (birds)",2018,123,123,2,0,121,123,2
27476,"Ring Levee Trail",29.785265,-90.110191,1230,"northern parula","Animalia","Bird",457,"Activity","Insect consumption",2018,123,123,2,0,121,123,2
27476,"Ring Levee Trail",29.785265,-90.110191,1230,"northern parula","Animalia","Bird",542,"Activity","Feeding (or foraging)",2018,123,123,2,0,121,123,2
27476,"Ring Levee Trail",29.785265,-90.110191,1616,"possumhaw","Plantae","Deciduous broadleaf",371,"Leaves","Breaking leaf buds",2018,354,354,21,0,333,354,21
27476,"Ring Levee Trail",29.785265,-90.110191,1616,"possumhaw","Plantae","Deciduous broadleaf",390,"Fruits","Ripe fruits",2018,82,82,0,5,82,87,5
27476,"Ring Levee Trail",29.785265,-90.110191,1616,"possumhaw","Plantae","Deciduous broadleaf",467,"Leaves","Increasing leaf size",2018,87,87,0,15,87,102,15
27476,"Ring Levee Trail",29.785265,-90.110191,1616,"possumhaw","Plantae","Deciduous broadleaf",471,"Leaves","Falling leaves",2018,29,333,4,21,25,354,329
27476,"Ring Levee Trail",29.785265,-90.110191,1616,"possumhaw","Plantae","Deciduous broadleaf",483,"Leaves","Leaves",2018,29,109,4,12,25,121,96
27476,"Ring Levee Trail",29.785265,-90.110191,1616,"possumhaw","Plantae","Deciduous broadleaf",498,"Leaves","Colored leaves",2018,312,312,28,21,284,333,49
27476,"Ring Levee Trail",29.785265,-90.110191,1616,"possumhaw","Plantae","Deciduous broadleaf",500,"Flowers","Flowers or flower buds",2018,82,82,0,5,82,87,5
27476,"Ring Levee Trail",29.785265,-90.110191,1616,"possumhaw","Plantae","Deciduous broadleaf",501,"Flowers","Open flowers",2018,82,82,0,5,82,87,5
27476,"Ring Levee Trail",29.785265,-90.110191,1616,"possumhaw","Plantae","Deciduous broadleaf",516,"Fruits","Fruits",2018,123,312,2,21,121,333,212
27477,"Bayou Coquille Trail",29.793816,-90.122452,2,"boxelder","Plantae","Deciduous broadleaf",371,"Leaves","Breaking leaf buds",2018,46,67,12,18,34,85,51
27477,"Bayou Coquille Trail",29.793816,-90.122452,2,"boxelder","Plantae","Deciduous broadleaf",467,"Leaves","Increasing leaf size",2018,57,253,11,3,46,256,210
27477,"Bayou Coquille Trail",29.793816,-90.122452,2,"boxelder","Plantae","Deciduous broadleaf",471,"Leaves","Falling leaves",2018,234,277,20,16,214,293,79
27477,"Bayou Coquille Trail",29.793816,-90.122452,2,"boxelder","Plantae","Deciduous broadleaf",483,"Leaves","Leaves",2018,57,319,11,21,46,340,294
27477,"Bayou Coquille Trail",29.793816,-90.122452,2,"boxelder","Plantae","Deciduous broadleaf",498,"Leaves","Colored leaves",2018,235,319,1,21,234,340,106
27477,"Bayou Coquille Trail",29.793816,-90.122452,2,"boxelder","Plantae","Deciduous broadleaf",500,"Flowers","Flowers or flower buds",2018,57,67,11,18,46,85,39
27477,"Bayou Coquille Trail",29.793816,-90.122452,2,"boxelder","Plantae","Deciduous broadleaf",501,"Flowers","Open flowers",2018,67,67,10,18,57,85,28
27477,"Bayou Coquille Trail",29.793816,-90.122452,2,"boxelder","Plantae","Deciduous broadleaf",502,"Flowers","Pollen release (flowers)",2018,85,85,0,21,85,106,21
27477,"Bayou Coquille Trail",29.793816,-90.122452,3,"red maple","Plantae","Deciduous broadleaf",390,"Fruits","Ripe fruits",2018,46,46,12,0,34,46,12
27477,"Bayou Coquille Trail",29.793816,-90.122452,3,"red maple","Plantae","Deciduous broadleaf",467,"Leaves","Increasing leaf size",2018,114,171,15.5,1,98.5,172,73.5
27477,"Bayou Coquille Trail",29.793816,-90.122452,3,"red maple","Plantae","Deciduous broadleaf",471,"Leaves","Falling leaves",2018,175,175,14,18,161,193,32
27477,"Bayou Coquille Trail",29.793816,-90.122452,3,"red maple","Plantae","Deciduous broadleaf",483,"Leaves","Leaves",2018,57,319,11,21,46,340,294
27477,"Bayou Coquille Trail",29.793816,-90.122452,3,"red maple","Plantae","Deciduous broadleaf",498,"Leaves","Colored leaves",2018,146,319,6,21,140,340,200
27477,"Bayou Coquille Trail",29.793816,-90.122452,3,"red maple","Plantae","Deciduous broadleaf",500,"Flowers","Flowers or flower buds",2018,34,145,13,9.5,21,154.5,133.5
27477,"Bayou Coquille Trail",29.793816,-90.122452,3,"red maple","Plantae","Deciduous broadleaf",501,"Flowers","Open flowers",2018,34,40,13,16.5,21,56.5,35.5
27477,"Bayou Coquille Trail",29.793816,-90.122452,3,"red maple","Plantae","Deciduous broadleaf",502,"Flowers","Pollen release (flowers)",2018,34,40,13,16.5,21,56.5,35.5
27477,"Bayou Coquille Trail",29.793816,-90.122452,3,"red maple","Plantae","Deciduous broadleaf",504,"Fruits","Recent fruit or seed drop",2018,67,67,21,0,46,67,21
27477,"Bayou Coquille Trail",29.793816,-90.122452,3,"red maple","Plantae","Deciduous broadleaf",516,"Fruits","Fruits",2018,46,46,12,0,34,46,12
27477,"Bayou Coquille Trail",29.793816,-90.122452,81,"sweetgum","Plantae","Deciduous broadleaf",371,"Leaves","Breaking leaf buds",2018,46,67,12,18,34,85,51
27477,"Bayou Coquille Trail",29.793816,-90.122452,81,"sweetgum","Plantae","Deciduous broadleaf",390,"Fruits","Ripe fruits",2018,151,263,21,13,130,276,146
27477,"Bayou Coquille Trail",29.793816,-90.122452,81,"sweetgum","Plantae","Deciduous broadleaf",467,"Leaves","Increasing leaf size",2018,57,143,11,8,46,151,105
27477,"Bayou Coquille Trail",29.793816,-90.122452,81,"sweetgum","Plantae","Deciduous broadleaf",471,"Leaves","Falling leaves",2018,235,293,1,26,234,319,85
27477,"Bayou Coquille Trail",29.793816,-90.122452,81,"sweetgum","Plantae","Deciduous broadleaf",483,"Leaves","Leaves",2018,57,57,11,0,46,57,11
27477,"Bayou Coquille Trail",29.793816,-90.122452,81,"sweetgum","Plantae","Deciduous broadleaf",498,"Leaves","Colored leaves",2018,235,253,1,3,234,256,22
27477,"Bayou Coquille Trail",29.793816,-90.122452,81,"sweetgum","Plantae","Deciduous broadleaf",504,"Fruits","Recent fruit or seed drop",2018,57,235,11,9,46,244,198
27477,"Bayou Coquille Trail",29.793816,-90.122452,81,"sweetgum","Plantae","Deciduous broadleaf",516,"Fruits","Fruits",2018,109,240,3,4,106,244,138
27477,"Bayou Coquille Trail",29.793816,-90.122452,201,"common buttonbush","Plantae","Deciduous broadleaf",371,"Leaves","Breaking leaf buds",2018,67,109,10,4,57,113,56
27477,"Bayou Coquille Trail",29.793816,-90.122452,201,"common buttonbush","Plantae","Deciduous broadleaf",390,"Fruits","Ripe fruits",2018,34,244,13,9,21,253,232
27477,"Bayou Coquille Trail",29.793816,-90.122452,201,"common buttonbush","Plantae","Deciduous broadleaf",467,"Leaves","Increasing leaf size",2018,67,172,10,10,57,182,125
27477,"Bayou Coquille Trail",29.793816,-90.122452,201,"common buttonbush","Plantae","Deciduous broadleaf",471,"Leaves","Falling leaves",2018,234,253,20,3,214,256,42
27477,"Bayou Coquille Trail",29.793816,-90.122452,201,"common buttonbush","Plantae","Deciduous broadleaf",483,"Leaves","Leaves",2018,67,67,10,0,57,67,10
27477,"Bayou Coquille Trail",29.793816,-90.122452,201,"common buttonbush","Plantae","Deciduous broadleaf",498,"Leaves","Colored leaves",2018,253,253,9,3,244,256,12
27477,"Bayou Coquille Trail",29.793816,-90.122452,201,"common buttonbush","Plantae","Deciduous broadleaf",500,"Flowers","Flowers or flower buds",2018,143,253,13,3,130,256,126
27477,"Bayou Coquille Trail",29.793816,-90.122452,201,"common buttonbush","Plantae","Deciduous broadleaf",501,"Flowers","Open flowers",2018,143,253,13,3,130,256,126
27477,"Bayou Coquille Trail",29.793816,-90.122452,201,"common buttonbush","Plantae","Deciduous broadleaf",504,"Fruits","Recent fruit or seed drop",2018,319,319,26,0,293,319,26
27477,"Bayou Coquille Trail",29.793816,-90.122452,201,"common buttonbush","Plantae","Deciduous broadleaf",516,"Fruits","Fruits",2018,34,214,13,20,21,234,213
27477,"Bayou Coquille Trail",29.793816,-90.122452,296,"bald cypress","Plantae","Deciduous conifer",392,"Seed cones","Unripe seed cones",2018,130,256,17,7,113,263,150
27477,"Bayou Coquille Trail",29.793816,-90.122452,296,"bald cypress","Plantae","Deciduous conifer",393,"Seed cones","Ripe seed cones",2018,130,319,17,21,113,340,227
27477,"Bayou Coquille Trail",29.793816,-90.122452,296,"bald cypress","Plantae","Deciduous conifer",472,"Needles","Falling needles",2018,214,214,21,20,193,234,41
27477,"Bayou Coquille Trail",29.793816,-90.122452,296,"bald cypress","Plantae","Deciduous conifer",481,"Needles","Breaking needle buds (deciduous)",2018,46,143,12,8,34,151,117
27477,"Bayou Coquille Trail",29.793816,-90.122452,296,"bald cypress","Plantae","Deciduous conifer",487,"Needles","Needles (deciduous)",2018,46,319,12,21,34,340,306
27477,"Bayou Coquille Trail",29.793816,-90.122452,296,"bald cypress","Plantae","Deciduous conifer",491,"Seed cones","Recent cone or seed drop",2018,235,235,1,5,234,240,6
27477,"Bayou Coquille Trail",29.793816,-90.122452,296,"bald cypress","Plantae","Deciduous conifer",499,"Needles","Colored needles",2018,182,319,10,21,172,340,168
27477,"Bayou Coquille Trail",29.793816,-90.122452,305,"live oak","Plantae","Semi-evergreen broadleaf",371,"Leaves","Breaking leaf buds",2018,57,67,11,18,46,85,39
27477,"Bayou Coquille Trail",29.793816,-90.122452,305,"live oak","Plantae","Semi-evergreen broadleaf",390,"Fruits","Ripe fruits",2018,235,293,1,26,234,319,85
27477,"Bayou Coquille Trail",29.793816,-90.122452,305,"live oak","Plantae","Semi-evergreen broadleaf",467,"Leaves","Increasing leaf size",2018,57,143,11,8,46,151,105
27477,"Bayou Coquille Trail",29.793816,-90.122452,305,"live oak","Plantae","Semi-evergreen broadleaf",471,"Leaves","Falling leaves",2018,253,253,9,3,244,256,12
27477,"Bayou Coquille Trail",29.793816,-90.122452,305,"live oak","Plantae","Semi-evergreen broadleaf",484,"Leaves","Young leaves (tree/shrub)",2018,57,85,11,24,46,109,63
27477,"Bayou Coquille Trail",29.793816,-90.122452,305,"live oak","Plantae","Semi-evergreen broadleaf",498,"Leaves","Colored leaves",2018,57,253,11,3,46,256,210
27477,"Bayou Coquille Trail",29.793816,-90.122452,305,"live oak","Plantae","Semi-evergreen broadleaf",500,"Flowers","Flowers or flower buds",2018,67,67,21,18,46,85,39
27477,"Bayou Coquille Trail",29.793816,-90.122452,305,"live oak","Plantae","Semi-evergreen broadleaf",501,"Flowers","Open flowers",2018,67,67,21,18,46,85,39
27477,"Bayou Coquille Trail",29.793816,-90.122452,305,"live oak","Plantae","Semi-evergreen broadleaf",502,"Flowers","Pollen release (flowers)",2018,67,67,21,0,46,67,21
27477,"Bayou Coquille Trail",29.793816,-90.122452,305,"live oak","Plantae","Semi-evergreen broadleaf",504,"Fruits","Recent fruit or seed drop",2018,253,319,9,21,244,340,96
27477,"Bayou Coquille Trail",29.793816,-90.122452,305,"live oak","Plantae","Semi-evergreen broadleaf",516,"Fruits","Fruits",2018,109,293,24,26,85,319,234
27477,"Bayou Coquille Trail",29.793816,-90.122452,309,"trumpet creeper","Plantae","Deciduous broadleaf",371,"Leaves","Breaking leaf buds",2018,263,263,7,13,256,276,20
27477,"Bayou Coquille Trail",29.793816,-90.122452,309,"trumpet creeper","Plantae","Deciduous broadleaf",390,"Fruits","Ripe fruits",2018,244,244,4,9,240,253,13
27477,"Bayou Coquille Trail",29.793816,-90.122452,309,"trumpet creeper","Plantae","Deciduous broadleaf",467,"Leaves","Increasing leaf size",2018,193,263,11,13,182,276,94
27477,"Bayou Coquille Trail",29.793816,-90.122452,309,"trumpet creeper","Plantae","Deciduous broadleaf",471,"Leaves","Falling leaves",2018,253,293,9,26,244,319,75
27477,"Bayou Coquille Trail",29.793816,-90.122452,309,"trumpet creeper","Plantae","Deciduous broadleaf",498,"Leaves","Colored leaves",2018,253,253,9,3,244,256,12
27477,"Bayou Coquille Trail",29.793816,-90.122452,309,"trumpet creeper","Plantae","Deciduous broadleaf",500,"Flowers","Flowers or flower buds",2018,143,276,13,1,130,277,147
27477,"Bayou Coquille Trail",29.793816,-90.122452,309,"trumpet creeper","Plantae","Deciduous broadleaf",501,"Flowers","Open flowers",2018,143,263,13,13,130,276,146
27477,"Bayou Coquille Trail",29.793816,-90.122452,309,"trumpet creeper","Plantae","Deciduous broadleaf",516,"Fruits","Fruits",2018,244,244,4,9,240,253,13
27477,"Bayou Coquille Trail",29.793816,-90.122452,722,"wax myrtle","Plantae","Evergreen broadleaf",371,"Leaves","Breaking leaf buds",2018,46,276,12,1,34,277,243
27477,"Bayou Coquille Trail",29.793816,-90.122452,722,"wax myrtle","Plantae","Evergreen broadleaf",390,"Fruits","Ripe fruits",2018,256,256,3,7,253,263,10
27477,"Bayou Coquille Trail",29.793816,-90.122452,722,"wax myrtle","Plantae","Evergreen broadleaf",484,"Leaves","Young leaves (tree/shrub)",2018,57,276,11,1,46,277,231
27477,"Bayou Coquille Trail",29.793816,-90.122452,722,"wax myrtle","Plantae","Evergreen broadleaf",500,"Flowers","Flowers or flower buds",2018,109,172,24,21,85,193,108
27477,"Bayou Coquille Trail",29.793816,-90.122452,722,"wax myrtle","Plantae","Evergreen broadleaf",516,"Fruits","Fruits",2018,214,244,21,9,193,253,60
27477,"Bayou Coquille Trail",29.793816,-90.122452,804,"eastern baccharis","Plantae","Deciduous broadleaf",371,"Leaves","Breaking leaf buds",2018,67,171,10,1,57,172,115
27477,"Bayou Coquille Trail",29.793816,-90.122452,804,"eastern baccharis","Plantae","Deciduous broadleaf",390,"Fruits","Ripe fruits",2018,293,293,16,26,277,319,42
27477,"Bayou Coquille Trail",29.793816,-90.122452,804,"eastern baccharis","Plantae","Deciduous broadleaf",467,"Leaves","Increasing leaf size",2018,46,263,12,13,34,276,242
27477,"Bayou Coquille Trail",29.793816,-90.122452,804,"eastern baccharis","Plantae","Deciduous broadleaf",471,"Leaves","Falling leaves",2018,143,143,13,8,130,151,21
27477,"Bayou Coquille Trail",29.793816,-90.122452,804,"eastern baccharis","Plantae","Deciduous broadleaf",498,"Leaves","Colored leaves",2018,143,143,13,8,130,151,21
27477,"Bayou Coquille Trail",29.793816,-90.122452,804,"eastern baccharis","Plantae","Deciduous broadleaf",500,"Flowers","Flowers or flower buds",2018,85,277,18,16,67,293,226
27477,"Bayou Coquille Trail",29.793816,-90.122452,804,"eastern baccharis","Plantae","Deciduous broadleaf",501,"Flowers","Open flowers",2018,85,277,18,16,67,293,226
27477,"Bayou Coquille Trail",29.793816,-90.122452,804,"eastern baccharis","Plantae","Deciduous broadleaf",502,"Flowers","Pollen release (flowers)",2018,113,277,4,16,109,293,184
27477,"Bayou Coquille Trail",29.793816,-90.122452,804,"eastern baccharis","Plantae","Deciduous broadleaf",504,"Fruits","Recent fruit or seed drop",2018,293,293,16,0,277,293,16
27477,"Bayou Coquille Trail",29.793816,-90.122452,804,"eastern baccharis","Plantae","Deciduous broadleaf",516,"Fruits","Fruits",2018,256,293,12,26,244,319,75
27477,"Bayou Coquille Trail",29.793816,-90.122452,940,"water tupelo ","Plantae","Deciduous broadleaf",371,"Leaves","Breaking leaf buds",2018,67,85,10,24,57,109,52
27477,"Bayou Coquille Trail",29.793816,-90.122452,940,"water tupelo ","Plantae","Deciduous broadleaf",390,"Fruits","Ripe fruits",2018,113,293,4,26,109,319,210
27477,"Bayou Coquille Trail",29.793816,-90.122452,940,"water tupelo ","Plantae","Deciduous broadleaf",467,"Leaves","Increasing leaf size",2018,85,235,18,5,67,240,173
27477,"Bayou Coquille Trail",29.793816,-90.122452,940,"water tupelo ","Plantae","Deciduous broadleaf",471,"Leaves","Falling leaves",2018,235,319,1,21,234,340,106
27477,"Bayou Coquille Trail",29.793816,-90.122452,940,"water tupelo ","Plantae","Deciduous broadleaf",483,"Leaves","Leaves",2018,85,319,18,21,67,340,273
27477,"Bayou Coquille Trail",29.793816,-90.122452,940,"water tupelo ","Plantae","Deciduous broadleaf",498,"Leaves","Colored leaves",2018,244,319,4,21,240,340,100
27477,"Bayou Coquille Trail",29.793816,-90.122452,940,"water tupelo ","Plantae","Deciduous broadleaf",504,"Fruits","Recent fruit or seed drop",2018,277,293,1,26,276,319,43
27477,"Bayou Coquille Trail",29.793816,-90.122452,940,"water tupelo ","Plantae","Deciduous broadleaf",516,"Fruits","Fruits",2018,106,293,21,26,85,319,234
27477,"Bayou Coquille Trail",29.793816,-90.122452,1044,"eastern poison ivy","Plantae","Deciduous broadleaf",371,"Leaves","Breaking leaf buds",2018,46,67,12,18,34,85,51
27477,"Bayou Coquille Trail",29.793816,-90.122452,1044,"eastern poison ivy","Plantae","Deciduous broadleaf",390,"Fruits","Ripe fruits",2018,151,319,8,21,143,340,197
27477,"Bayou Coquille Trail",29.793816,-90.122452,1044,"eastern poison ivy","Plantae","Deciduous broadleaf",467,"Leaves","Increasing leaf size",2018,67,253,10,3,57,256,199
27477,"Bayou Coquille Trail",29.793816,-90.122452,1044,"eastern poison ivy","Plantae","Deciduous broadleaf",471,"Leaves","Falling leaves",2018,235,244,21,9,214,253,39
27477,"Bayou Coquille Trail",29.793816,-90.122452,1044,"eastern poison ivy","Plantae","Deciduous broadleaf",483,"Leaves","Leaves",2018,67,67,10,0,57,67,10
27477,"Bayou Coquille Trail",29.793816,-90.122452,1044,"eastern poison ivy","Plantae","Deciduous broadleaf",498,"Leaves","Colored leaves",2018,235,253,21,3,214,256,42
27477,"Bayou Coquille Trail",29.793816,-90.122452,1044,"eastern poison ivy","Plantae","Deciduous broadleaf",500,"Flowers","Flowers or flower buds",2018,85,143,18,8,67,151,84
27477,"Bayou Coquille Trail",29.793816,-90.122452,1044,"eastern poison ivy","Plantae","Deciduous broadleaf",501,"Flowers","Open flowers",2018,106,113,21,17,85,130,45
27477,"Bayou Coquille Trail",29.793816,-90.122452,1044,"eastern poison ivy","Plantae","Deciduous broadleaf",502,"Flowers","Pollen release (flowers)",2018,109,113,3,17,106,130,24
27477,"Bayou Coquille Trail",29.793816,-90.122452,1044,"eastern poison ivy","Plantae","Deciduous broadleaf",504,"Fruits","Recent fruit or seed drop",2018,151,151,8,21,143,172,29
27477,"Bayou Coquille Trail",29.793816,-90.122452,1044,"eastern poison ivy","Plantae","Deciduous broadleaf",516,"Fruits","Fruits",2018,130,319,17,21,113,340,227
27477,"Bayou Coquille Trail",29.793816,-90.122452,1045,"Chinese tallow","Plantae","Deciduous broadleaf",371,"Leaves","Breaking leaf buds",2018,67,171,10,1,57,172,115
27477,"Bayou Coquille Trail",29.793816,-90.122452,1045,"Chinese tallow","Plantae","Deciduous broadleaf",467,"Leaves","Increasing leaf size",2018,67,235,10,5,57,240,183
27477,"Bayou Coquille Trail",29.793816,-90.122452,1045,"Chinese tallow","Plantae","Deciduous broadleaf",471,"Leaves","Falling leaves",2018,234,234,20,1,214,235,21
27477,"Bayou Coquille Trail",29.793816,-90.122452,1045,"Chinese tallow","Plantae","Deciduous broadleaf",483,"Leaves","Leaves",2018,67,256,10,7,57,263,206
27477,"Bayou Coquille Trail",29.793816,-90.122452,1045,"Chinese tallow","Plantae","Deciduous broadleaf",498,"Leaves","Colored leaves",2018,193,256,11,7,182,263,81
27477,"Bayou Coquille Trail",29.793816,-90.122452,1045,"Chinese tallow","Plantae","Deciduous broadleaf",500,"Flowers","Flowers or flower buds",2018,130,151,17,20,113,171,58
27477,"Bayou Coquille Trail",29.793816,-90.122452,1045,"Chinese tallow","Plantae","Deciduous broadleaf",501,"Flowers","Open flowers",2018,151,151,8,20,143,171,28
27477,"Bayou Coquille Trail",29.793816,-90.122452,1045,"Chinese tallow","Plantae","Deciduous broadleaf",516,"Fruits","Fruits",2018,193,235,21,21,172,256,84
27477,"Bayou Coquille Trail",29.793816,-90.122452,1111,"painted bunting","Animalia","Bird",292,"Activity","Active individuals",2018,172,172,21,0,151,172,21
27477,"Bayou Coquille Trail",29.793816,-90.122452,1111,"painted bunting","Animalia","Bird",293,"Activity","Calls or song (birds)",2018,141,141,5,10,136,151,15
27477,"Bayou Coquille Trail",29.793816,-90.122452,1111,"painted bunting","Animalia","Bird",294,"Activity","Singing individuals (birds)",2018,141,141,5,10,136,151,15
27477,"Bayou Coquille Trail",29.793816,-90.122452,1122,"barred owl","Animalia","Bird",292,"Activity","Active individuals",2018,143,143,2,8,141,151,10
27477,"Bayou Coquille Trail",29.793816,-90.122452,1122,"barred owl","Animalia","Bird",293,"Activity","Calls or song (birds)",2018,114,141,8,10,106,151,45
27477,"Bayou Coquille Trail",29.793816,-90.122452,1126,"Carolina wren","Animalia","Bird",292,"Activity","Active individuals",2018,130,165,3,7,127,172,45
27477,"Bayou Coquille Trail",29.793816,-90.122452,1126,"Carolina wren","Animalia","Bird",293,"Activity","Calls or song (birds)",2018,99,165,7,7,92,172,80
27477,"Bayou Coquille Trail",29.793816,-90.122452,1126,"Carolina wren","Animalia","Bird",294,"Activity","Singing individuals (birds)",2018,99,165,7,7,92,172,80
27477,"Bayou Coquille Trail",29.793816,-90.122452,1126,"Carolina wren","Animalia","Bird",295,"Activity","Territorial individuals (birds)",2018,134,134,4,2,130,136,6
27477,"Bayou Coquille Trail",29.793816,-90.122452,1126,"Carolina wren","Animalia","Bird",457,"Activity","Insect consumption",2018,134,165,4,7,130,172,42
27477,"Bayou Coquille Trail",29.793816,-90.122452,1126,"Carolina wren","Animalia","Bird",542,"Activity","Feeding (or foraging)",2018,99,165,7,7,92,172,80
27477,"Bayou Coquille Trail",29.793816,-90.122452,1230,"northern parula","Animalia","Bird",292,"Activity","Active individuals",2018,136,165,2,7,134,172,38
27477,"Bayou Coquille Trail",29.793816,-90.122452,1230,"northern parula","Animalia","Bird",293,"Activity","Calls or song (birds)",2018,141,141,5,10,136,151,15
27477,"Bayou Coquille Trail",29.793816,-90.122452,1230,"northern parula","Animalia","Bird",294,"Activity","Singing individuals (birds)",2018,141,141,5,10,136,151,15
27477,"Bayou Coquille Trail",29.793816,-90.122452,1230,"northern parula","Animalia","Bird",295,"Activity","Territorial individuals (birds)",2018,92,92,0,7,92,99,7
27477,"Bayou Coquille Trail",29.793816,-90.122452,1230,"northern parula","Animalia","Bird",457,"Activity","Insect consumption",2018,165,165,14,7,151,172,21
27477,"Bayou Coquille Trail",29.793816,-90.122452,1230,"northern parula","Animalia","Bird",542,"Activity","Feeding (or foraging)",2018,165,165,14,7,151,172,21
27477,"Bayou Coquille Trail",29.793816,-90.122452,1236,"hooded warbler","Animalia","Bird",292,"Activity","Active individuals",2018,99,165,7,7,92,172,80
27477,"Bayou Coquille Trail",29.793816,-90.122452,1236,"hooded warbler","Animalia","Bird",293,"Activity","Calls or song (birds)",2018,106,165,7,7,99,172,73
27477,"Bayou Coquille Trail",29.793816,-90.122452,1236,"hooded warbler","Animalia","Bird",294,"Activity","Singing individuals (birds)",2018,106,165,7,7,99,172,73
27477,"Bayou Coquille Trail",29.793816,-90.122452,1236,"hooded warbler","Animalia","Bird",295,"Activity","Territorial individuals (birds)",2018,106,106,7,8,99,114,15
27477,"Bayou Coquille Trail",29.793816,-90.122452,1236,"hooded warbler","Animalia","Bird",542,"Activity","Feeding (or foraging)",2018,99,165,7,7,92,172,80
27477,"Bayou Coquille Trail",29.793816,-90.122452,1605,"sugarberry","Plantae","Deciduous broadleaf",371,"Leaves","Breaking leaf buds",2018,67,67,10,0,57,67,10
27477,"Bayou Coquille Trail",29.793816,-90.122452,1605,"sugarberry","Plantae","Deciduous broadleaf",467,"Leaves","Increasing leaf size",2018,67,67,10,0,57,67,10
27477,"Bayou Coquille Trail",29.793816,-90.122452,1605,"sugarberry","Plantae","Deciduous broadleaf",471,"Leaves","Falling leaves",2018,253,293,9,26,244,319,75
27477,"Bayou Coquille Trail",29.793816,-90.122452,1605,"sugarberry","Plantae","Deciduous broadleaf",483,"Leaves","Leaves",2018,67,319,10,21,57,340,283
27477,"Bayou Coquille Trail",29.793816,-90.122452,1605,"sugarberry","Plantae","Deciduous broadleaf",498,"Leaves","Colored leaves",2018,253,319,9,21,244,340,96
27477,"Bayou Coquille Trail",29.793816,-90.122452,1605,"sugarberry","Plantae","Deciduous broadleaf",516,"Fruits","Fruits",2018,172,263,21,13,151,276,125
27477,"Bayou Coquille Trail",29.793816,-90.122452,1616,"possumhaw","Plantae","Deciduous broadleaf",371,"Leaves","Breaking leaf buds",2018,67,85,10,24,57,109,52
27477,"Bayou Coquille Trail",29.793816,-90.122452,1616,"possumhaw","Plantae","Deciduous broadleaf",467,"Leaves","Increasing leaf size",2018,67,171,10,1,57,172,115
27477,"Bayou Coquille Trail",29.793816,-90.122452,1616,"possumhaw","Plantae","Deciduous broadleaf",483,"Leaves","Leaves",2018,67,319,10,21,57,340,283
27477,"Bayou Coquille Trail",29.793816,-90.122452,1616,"possumhaw","Plantae","Deciduous broadleaf",498,"Leaves","Colored leaves",2018,240,240,5,4,235,244,9
27477,"Bayou Coquille Trail",29.793816,-90.122452,1616,"possumhaw","Plantae","Deciduous broadleaf",500,"Flowers","Flowers or flower buds",2018,67,67,10,18,57,85,28
27477,"Bayou Coquille Trail",29.793816,-90.122452,1616,"possumhaw","Plantae","Deciduous broadleaf",501,"Flowers","Open flowers",2018,67,67,10,18,57,85,28
27477,"Bayou Coquille Trail",29.793816,-90.122452,1661,"red-bellied woodpecker","Animalia","Bird",292,"Activity","Active individuals",2018,99,165,7,7,92,172,80
27477,"Bayou Coquille Trail",29.793816,-90.122452,1661,"red-bellied woodpecker","Animalia","Bird",293,"Activity","Calls or song (birds)",2018,122,141,8,10,114,151,37
27477,"Bayou Coquille Trail",29.793816,-90.122452,1661,"red-bellied woodpecker","Animalia","Bird",295,"Activity","Territorial individuals (birds)",2018,99,151,7,8,92,159,67
27477,"Bayou Coquille Trail",29.793816,-90.122452,1661,"red-bellied woodpecker","Animalia","Bird",308,"Development","Fledged young (altricial birds)",2018,159,165,8,7,151,172,21
27477,"Bayou Coquille Trail",29.793816,-90.122452,1661,"red-bellied woodpecker","Animalia","Bird",310,"Activity","Fruit/seed consumption",2018,159,159,8,6,151,165,14
27477,"Bayou Coquille Trail",29.793816,-90.122452,1661,"red-bellied woodpecker","Animalia","Bird",311,"Activity","Nut gathering",2018,159,159,8,6,151,165,14
27477,"Bayou Coquille Trail",29.793816,-90.122452,1661,"red-bellied woodpecker","Animalia","Bird",457,"Activity","Insect consumption",2018,114,134,8,2,106,136,30
27477,"Bayou Coquille Trail",29.793816,-90.122452,1661,"red-bellied woodpecker","Animalia","Bird",542,"Activity","Feeding (or foraging)",2018,99,159,7,13,92,172,80
27477,"Bayou Coquille Trail",29.793816,-90.122452,1710,"prothonotary warbler","Animalia","Bird",295,"Activity","Territorial individuals (birds)",2018,122,141,8,10,114,151,37
27477,"Bayou Coquille Trail",29.793816,-90.122452,1710,"prothonotary warbler","Animalia","Bird",297,"Reproduction","Nest building (birds)",2018,92,92,0,7,92,99,7
27477,"Bayou Coquille Trail",29.793816,-90.122452,1710,"prothonotary warbler","Animalia","Bird",298,"Reproduction","Occupied nest",2018,114,159,8,13,106,172,66
27477,"Bayou Coquille Trail",29.793816,-90.122452,1710,"prothonotary warbler","Animalia","Bird",304,"Development","Nestlings (altricial birds)",2018,159,159,18,13,141,172,31
27477,"Bayou Coquille Trail",29.793816,-90.122452,1710,"prothonotary warbler","Animalia","Bird",308,"Development","Fledged young (altricial birds)",2018,134,134,4,2,130,136,6
27477,"Bayou Coquille Trail",29.793816,-90.122452,1710,"prothonotary warbler","Animalia","Bird",310,"Activity","Fruit/seed consumption",2018,136,159,2,13,134,172,38
27477,"Bayou Coquille Trail",29.793816,-90.122452,1710,"prothonotary warbler","Animalia","Bird",312,"Activity","Flower visitation",2018,130,130,3,4,127,134,7
27477,"Bayou Coquille Trail",29.793816,-90.122452,1710,"prothonotary warbler","Animalia","Bird",457,"Activity","Insect consumption",2018,136,159,2,13,134,172,38
27474,"Visitor Center Trail",29.784473,-90.114784,81,"sweetgum","Plantae","Deciduous broadleaf",371,"Leaves","Breaking leaf buds",2019,73,73,0,14,73,87,14
27474,"Visitor Center Trail",29.784473,-90.114784,81,"sweetgum","Plantae","Deciduous broadleaf",467,"Leaves","Increasing leaf size",2019,117,117,0,19,117,136,19
27474,"Visitor Center Trail",29.784473,-90.114784,81,"sweetgum","Plantae","Deciduous broadleaf",504,"Fruits","Recent fruit or seed drop",2019,21,21,11,10,10,31,21
27474,"Visitor Center Trail",29.784473,-90.114784,81,"sweetgum","Plantae","Deciduous broadleaf",516,"Fruits","Fruits",2019,31,31,10,0,21,31,10
27474,"Visitor Center Trail",29.784473,-90.114784,201,"common buttonbush","Plantae","Deciduous broadleaf",390,"Fruits","Ripe fruits",2019,87,87,14,30,73,117,44
27474,"Visitor Center Trail",29.784473,-90.114784,201,"common buttonbush","Plantae","Deciduous broadleaf",500,"Flowers","Flowers or flower buds",2019,136,136,19,0,117,136,19
27474,"Visitor Center Trail",29.784473,-90.114784,208,"white crownbeard","Plantae","Forb",390,"Fruits","Ripe fruits",2019,31,31,21,0,10,31,21
27474,"Visitor Center Trail",29.784473,-90.114784,208,"white crownbeard","Plantae","Forb",504,"Fruits","Recent fruit or seed drop",2019,31,31,21,0,10,31,21
27474,"Visitor Center Trail",29.784473,-90.114784,208,"white crownbeard","Plantae","Forb",516,"Fruits","Fruits",2019,31,31,21,0,10,31,21
27474,"Visitor Center Trail",29.784473,-90.114784,309,"trumpet creeper","Plantae","Deciduous broadleaf",471,"Leaves","Falling leaves",2019,21,21,0,10,21,31,10
27474,"Visitor Center Trail",29.784473,-90.114784,309,"trumpet creeper","Plantae","Deciduous broadleaf",483,"Leaves","Leaves",2019,21,21,0,10,21,31,10
27474,"Visitor Center Trail",29.784473,-90.114784,722,"wax myrtle","Plantae","Evergreen broadleaf",371,"Leaves","Breaking leaf buds",2019,21,21,11,0,10,21,11
27474,"Visitor Center Trail",29.784473,-90.114784,804,"eastern baccharis","Plantae","Deciduous broadleaf",371,"Leaves","Breaking leaf buds",2019,31,73,21,14,10,87,77
27475,"Palmetto Trail",29.783813,-90.117561,3,"red maple","Plantae","Deciduous broadleaf",371,"Leaves","Breaking leaf buds",2019,73,73,0,8,73,81,8
27475,"Palmetto Trail",29.783813,-90.117561,3,"red maple","Plantae","Deciduous broadleaf",467,"Leaves","Increasing leaf size",2019,117,117,0,19,117,136,19
27475,"Palmetto Trail",29.783813,-90.117561,81,"sweetgum","Plantae","Deciduous broadleaf",467,"Leaves","Increasing leaf size",2019,117,117,0,19,117,136,19
27475,"Palmetto Trail",29.783813,-90.117561,81,"sweetgum","Plantae","Deciduous broadleaf",471,"Leaves","Falling leaves",2019,21,21,11,10,10,31,21
27475,"Palmetto Trail",29.783813,-90.117561,81,"sweetgum","Plantae","Deciduous broadleaf",498,"Leaves","Colored leaves",2019,21,21,11,10,10,31,21
27475,"Palmetto Trail",29.783813,-90.117561,81,"sweetgum","Plantae","Deciduous broadleaf",500,"Flowers","Flowers or flower buds",2019,31,31,10,0,21,31,10
27475,"Palmetto Trail",29.783813,-90.117561,81,"sweetgum","Plantae","Deciduous broadleaf",516,"Fruits","Fruits",2019,31,31,15.5,0,15.5,31,15.5
27475,"Palmetto Trail",29.783813,-90.117561,296,"bald cypress","Plantae","Deciduous conifer",392,"Seed cones","Unripe seed cones",2019,73,73,0,8,73,81,8
27475,"Palmetto Trail",29.783813,-90.117561,296,"bald cypress","Plantae","Deciduous conifer",472,"Needles","Falling needles",2019,21,21,11,10,10,31,21
27475,"Palmetto Trail",29.783813,-90.117561,296,"bald cypress","Plantae","Deciduous conifer",481,"Needles","Breaking needle buds (deciduous)",2019,31,31,21,0,10,31,21
27475,"Palmetto Trail",29.783813,-90.117561,296,"bald cypress","Plantae","Deciduous conifer",490,"Pollen cones","Pollen cones (conifers)",2019,73,73,0,8,73,81,8
27475,"Palmetto Trail",29.783813,-90.117561,296,"bald cypress","Plantae","Deciduous conifer",491,"Seed cones","Recent cone or seed drop",2019,21,21,11,10,10,31,21
27475,"Palmetto Trail",29.783813,-90.117561,296,"bald cypress","Plantae","Deciduous conifer",495,"Pollen cones","Open pollen cones (conifers)",2019,21,73,11,8,10,81,71
27475,"Palmetto Trail",29.783813,-90.117561,296,"bald cypress","Plantae","Deciduous conifer",503,"Pollen cones","Pollen release (conifers)",2019,31,31,10,0,21,31,10
27475,"Palmetto Trail",29.783813,-90.117561,305,"live oak","Plantae","Semi-evergreen broadleaf",467,"Leaves","Increasing leaf size",2019,117,117,0,19,117,136,19
27475,"Palmetto Trail",29.783813,-90.117561,305,"live oak","Plantae","Semi-evergreen broadleaf",483,"Leaves","Leaves",2019,10,10,0,21,10,31,21
27475,"Palmetto Trail",29.783813,-90.117561,305,"live oak","Plantae","Semi-evergreen broadleaf",484,"Leaves","Young leaves (tree/shrub)",2019,117,117,0,19,117,136,19
27475,"Palmetto Trail",29.783813,-90.117561,309,"trumpet creeper","Plantae","Deciduous broadleaf",371,"Leaves","Breaking leaf buds",2019,136,136,19,0,117,136,19
27475,"Palmetto Trail",29.783813,-90.117561,309,"trumpet creeper","Plantae","Deciduous broadleaf",500,"Flowers","Flowers or flower buds",2019,136,136,19,0,117,136,19
27475,"Palmetto Trail",29.783813,-90.117561,722,"wax myrtle","Plantae","Evergreen broadleaf",371,"Leaves","Breaking leaf buds",2019,136,136,19,0,117,136,19
27475,"Palmetto Trail",29.783813,-90.117561,804,"eastern baccharis","Plantae","Deciduous broadleaf",371,"Leaves","Breaking leaf buds",2019,31,31,21,0,10,31,21
27475,"Palmetto Trail",29.783813,-90.117561,940,"water tupelo ","Plantae","Deciduous broadleaf",467,"Leaves","Increasing leaf size",2019,117,117,0,19,117,136,19
27475,"Palmetto Trail",29.783813,-90.117561,940,"water tupelo ","Plantae","Deciduous broadleaf",471,"Leaves","Falling leaves",2019,21,21,11,10,10,31,21
27475,"Palmetto Trail",29.783813,-90.117561,940,"water tupelo ","Plantae","Deciduous broadleaf",483,"Leaves","Leaves",2019,21,21,11,10,10,31,21
27475,"Palmetto Trail",29.783813,-90.117561,940,"water tupelo ","Plantae","Deciduous broadleaf",498,"Leaves","Colored leaves",2019,21,21,11,10,10,31,21
27475,"Palmetto Trail",29.783813,-90.117561,1044,"eastern poison ivy","Plantae","Deciduous broadleaf",371,"Leaves","Breaking leaf buds",2019,73,73,0,8,73,81,8
27475,"Palmetto Trail",29.783813,-90.117561,1044,"eastern poison ivy","Plantae","Deciduous broadleaf",500,"Flowers","Flowers or flower buds",2019,31,117,21,19,10,136,126
27475,"Palmetto Trail",29.783813,-90.117561,1044,"eastern poison ivy","Plantae","Deciduous broadleaf",501,"Flowers","Open flowers",2019,117,117,0,19,117,136,19
27475,"Palmetto Trail",29.783813,-90.117561,1044,"eastern poison ivy","Plantae","Deciduous broadleaf",516,"Fruits","Fruits",2019,136,136,19,0,117,136,19
27475,"Palmetto Trail",29.783813,-90.117561,1616,"possumhaw","Plantae","Deciduous broadleaf",371,"Leaves","Breaking leaf buds",2019,10,10,0,21,10,31,21
27475,"Palmetto Trail",29.783813,-90.117561,1616,"possumhaw","Plantae","Deciduous broadleaf",390,"Fruits","Ripe fruits",2019,73,73,0,8,73,81,8
27475,"Palmetto Trail",29.783813,-90.117561,1616,"possumhaw","Plantae","Deciduous broadleaf",500,"Flowers","Flowers or flower buds",2019,73,73,0,8,73,81,8
27475,"Palmetto Trail",29.783813,-90.117561,1616,"possumhaw","Plantae","Deciduous broadleaf",501,"Flowers","Open flowers",2019,73,73,0,8,73,81,8
27475,"Palmetto Trail",29.783813,-90.117561,1616,"possumhaw","Plantae","Deciduous broadleaf",516,"Fruits","Fruits",2019,81,81,8,0,73,81,8
27476,"Ring Levee Trail",29.785265,-90.110191,2,"boxelder","Plantae","Deciduous broadleaf",371,"Leaves","Breaking leaf buds",2019,59,59,5,14,54,73,19
27476,"Ring Levee Trail",29.785265,-90.110191,2,"boxelder","Plantae","Deciduous broadleaf",467,"Leaves","Increasing leaf size",2019,38,143,21,28,17,171,154
27476,"Ring Levee Trail",29.785265,-90.110191,2,"boxelder","Plantae","Deciduous broadleaf",483,"Leaves","Leaves",2019,38,38,21,0,17,38,21
27476,"Ring Levee Trail",29.785265,-90.110191,2,"boxelder","Plantae","Deciduous broadleaf",500,"Flowers","Flowers or flower buds",2019,38,59,21,14,17,73,56
27476,"Ring Levee Trail",29.785265,-90.110191,2,"boxelder","Plantae","Deciduous broadleaf",501,"Flowers","Open flowers",2019,54,59,16,14,38,73,35
27476,"Ring Levee Trail",29.785265,-90.110191,2,"boxelder","Plantae","Deciduous broadleaf",502,"Flowers","Pollen release (flowers)",2019,59,59,5,14,54,73,19
27476,"Ring Levee Trail",29.785265,-90.110191,3,"red maple","Plantae","Deciduous broadleaf",371,"Leaves","Breaking leaf buds",2019,38,38,21,16,17,54,37
27476,"Ring Levee Trail",29.785265,-90.110191,3,"red maple","Plantae","Deciduous broadleaf",467,"Leaves","Increasing leaf size",2019,38,87,21,14,17,101,84
27476,"Ring Levee Trail",29.785265,-90.110191,3,"red maple","Plantae","Deciduous broadleaf",483,"Leaves","Leaves",2019,38,38,21,0,17,38,21
27476,"Ring Levee Trail",29.785265,-90.110191,3,"red maple","Plantae","Deciduous broadleaf",500,"Flowers","Flowers or flower buds",2019,17,17,0,21,17,38,21
27476,"Ring Levee Trail",29.785265,-90.110191,3,"red maple","Plantae","Deciduous broadleaf",501,"Flowers","Open flowers",2019,17,17,0,21,17,38,21
27476,"Ring Levee Trail",29.785265,-90.110191,81,"sweetgum","Plantae","Deciduous broadleaf",371,"Leaves","Breaking leaf buds",2019,80,80,7,1,73,81,8
27476,"Ring Levee Trail",29.785265,-90.110191,81,"sweetgum","Plantae","Deciduous broadleaf",390,"Fruits","Ripe fruits",2019,38,87,21,14,17,101,84
27476,"Ring Levee Trail",29.785265,-90.110191,81,"sweetgum","Plantae","Deciduous broadleaf",467,"Leaves","Increasing leaf size",2019,54,101,16,21,38,122,84
27476,"Ring Levee Trail",29.785265,-90.110191,81,"sweetgum","Plantae","Deciduous broadleaf",483,"Leaves","Leaves",2019,54,54,16,0,38,54,16
27476,"Ring Levee Trail",29.785265,-90.110191,81,"sweetgum","Plantae","Deciduous broadleaf",500,"Flowers","Flowers or flower buds",2019,54,80,16,1,38,81,43
27476,"Ring Levee Trail",29.785265,-90.110191,81,"sweetgum","Plantae","Deciduous broadleaf",501,"Flowers","Open flowers",2019,54,80,16,1,38,81,43
27476,"Ring Levee Trail",29.785265,-90.110191,81,"sweetgum","Plantae","Deciduous broadleaf",504,"Fruits","Recent fruit or seed drop",2019,54,54,0,5,54,59,5
27476,"Ring Levee Trail",29.785265,-90.110191,81,"sweetgum","Plantae","Deciduous broadleaf",516,"Fruits","Fruits",2019,54,87,16,14,38,101,63
27476,"Ring Levee Trail",29.785265,-90.110191,296,"bald cypress","Plantae","Deciduous conifer",392,"Seed cones","Unripe seed cones",2019,122,122,21,0,101,122,21
27476,"Ring Levee Trail",29.785265,-90.110191,296,"bald cypress","Plantae","Deciduous conifer",393,"Seed cones","Ripe seed cones",2019,122,143,21,28,101,171,70
27476,"Ring Levee Trail",29.785265,-90.110191,296,"bald cypress","Plantae","Deciduous conifer",481,"Needles","Breaking needle buds (deciduous)",2019,59,101,21,21,38,122,84
27476,"Ring Levee Trail",29.785265,-90.110191,296,"bald cypress","Plantae","Deciduous conifer",487,"Needles","Needles (deciduous)",2019,59,59,21,0,38,59,21
27476,"Ring Levee Trail",29.785265,-90.110191,296,"bald cypress","Plantae","Deciduous conifer",490,"Pollen cones","Pollen cones (conifers)",2019,80,101,7,21,73,122,49
27476,"Ring Levee Trail",29.785265,-90.110191,296,"bald cypress","Plantae","Deciduous conifer",495,"Pollen cones","Open pollen cones (conifers)",2019,80,143,7,28,73,171,98
27476,"Ring Levee Trail",29.785265,-90.110191,296,"bald cypress","Plantae","Deciduous conifer",503,"Pollen cones","Pollen release (conifers)",2019,80,143,7,28,73,171,98
27476,"Ring Levee Trail",29.785265,-90.110191,305,"live oak","Plantae","Semi-evergreen broadleaf",371,"Leaves","Breaking leaf buds",2019,80,80,7,1,73,81,8
27476,"Ring Levee Trail",29.785265,-90.110191,305,"live oak","Plantae","Semi-evergreen broadleaf",390,"Fruits","Ripe fruits",2019,87,87,6,14,81,101,20
27476,"Ring Levee Trail",29.785265,-90.110191,305,"live oak","Plantae","Semi-evergreen broadleaf",467,"Leaves","Increasing leaf size",2019,54,101,16,21,38,122,84
27476,"Ring Levee Trail",29.785265,-90.110191,305,"live oak","Plantae","Semi-evergreen broadleaf",471,"Leaves","Falling leaves",2019,54,81,16,20,38,101,63
27476,"Ring Levee Trail",29.785265,-90.110191,305,"live oak","Plantae","Semi-evergreen broadleaf",484,"Leaves","Young leaves (tree/shrub)",2019,80,101,7,21,73,122,49
27476,"Ring Levee Trail",29.785265,-90.110191,305,"live oak","Plantae","Semi-evergreen broadleaf",498,"Leaves","Colored leaves",2019,54,81,16,20,38,101,63
27476,"Ring Levee Trail",29.785265,-90.110191,305,"live oak","Plantae","Semi-evergreen broadleaf",500,"Flowers","Flowers or flower buds",2019,80,80,7,1,73,81,8
27476,"Ring Levee Trail",29.785265,-90.110191,305,"live oak","Plantae","Semi-evergreen broadleaf",501,"Flowers","Open flowers",2019,80,80,7,1,73,81,8
27476,"Ring Levee Trail",29.785265,-90.110191,305,"live oak","Plantae","Semi-evergreen broadleaf",502,"Flowers","Pollen release (flowers)",2019,73,87,14,14,59,101,42
27476,"Ring Levee Trail",29.785265,-90.110191,309,"trumpet creeper","Plantae","Deciduous broadleaf",371,"Leaves","Breaking leaf buds",2019,59,81,21,20,38,101,63
27476,"Ring Levee Trail",29.785265,-90.110191,309,"trumpet creeper","Plantae","Deciduous broadleaf",467,"Leaves","Increasing leaf size",2019,59,80,21,1,38,81,43
27476,"Ring Levee Trail",29.785265,-90.110191,309,"trumpet creeper","Plantae","Deciduous broadleaf",483,"Leaves","Leaves",2019,59,80,21,1,38,81,43
27476,"Ring Levee Trail",29.785265,-90.110191,309,"trumpet creeper","Plantae","Deciduous broadleaf",500,"Flowers","Flowers or flower buds",2019,171,171,28,0,143,171,28
27476,"Ring Levee Trail",29.785265,-90.110191,309,"trumpet creeper","Plantae","Deciduous broadleaf",501,"Flowers","Open flowers",2019,171,171,28,0,143,171,28
27476,"Ring Levee Trail",29.785265,-90.110191,722,"wax myrtle","Plantae","Evergreen broadleaf",371,"Leaves","Breaking leaf buds",2019,59,59,0,14,59,73,14
27476,"Ring Levee Trail",29.785265,-90.110191,722,"wax myrtle","Plantae","Evergreen broadleaf",390,"Fruits","Ripe fruits",2019,81,81,1,20,80,101,21
27476,"Ring Levee Trail",29.785265,-90.110191,722,"wax myrtle","Plantae","Evergreen broadleaf",484,"Leaves","Young leaves (tree/shrub)",2019,143,143,0,28,143,171,28
27476,"Ring Levee Trail",29.785265,-90.110191,722,"wax myrtle","Plantae","Evergreen broadleaf",500,"Flowers","Flowers or flower buds",2019,38,143,21,28,17,171,154
27476,"Ring Levee Trail",29.785265,-90.110191,722,"wax myrtle","Plantae","Evergreen broadleaf",516,"Fruits","Fruits",2019,81,81,1,20,80,101,21
27476,"Ring Levee Trail",29.785265,-90.110191,812,"American beautyberry","Plantae","Deciduous broadleaf",371,"Leaves","Breaking leaf buds",2019,38,143,21,28,17,171,154
27476,"Ring Levee Trail",29.785265,-90.110191,812,"American beautyberry","Plantae","Deciduous broadleaf",467,"Leaves","Increasing leaf size",2019,59,59,21,0,38,59,21
27476,"Ring Levee Trail",29.785265,-90.110191,812,"American beautyberry","Plantae","Deciduous broadleaf",483,"Leaves","Leaves",2019,59,59,21,0,38,59,21
27476,"Ring Levee Trail",29.785265,-90.110191,812,"American beautyberry","Plantae","Deciduous broadleaf",500,"Flowers","Flowers or flower buds",2019,122,143,21,28,101,171,70
27476,"Ring Levee Trail",29.785265,-90.110191,812,"American beautyberry","Plantae","Deciduous broadleaf",501,"Flowers","Open flowers",2019,171,171,28,0,143,171,28
27476,"Ring Levee Trail",29.785265,-90.110191,812,"American beautyberry","Plantae","Deciduous broadleaf",516,"Fruits","Fruits",2019,171,171,28,0,143,171,28
27476,"Ring Levee Trail",29.785265,-90.110191,885,"honeylocust","Plantae","Deciduous broadleaf",371,"Leaves","Breaking leaf buds",2019,59,101,5,21,54,122,68
27476,"Ring Levee Trail",29.785265,-90.110191,885,"honeylocust","Plantae","Deciduous broadleaf",390,"Fruits","Ripe fruits",2019,87,101,6,21,81,122,41
27476,"Ring Levee Trail",29.785265,-90.110191,885,"honeylocust","Plantae","Deciduous broadleaf",467,"Leaves","Increasing leaf size",2019,80,80,7,0,73,80,7
27476,"Ring Levee Trail",29.785265,-90.110191,885,"honeylocust","Plantae","Deciduous broadleaf",483,"Leaves","Leaves",2019,80,80,7,0,73,80,7
27476,"Ring Levee Trail",29.785265,-90.110191,885,"honeylocust","Plantae","Deciduous broadleaf",504,"Fruits","Recent fruit or seed drop",2019,81,81,1,6,80,87,7
27476,"Ring Levee Trail",29.785265,-90.110191,885,"honeylocust","Plantae","Deciduous broadleaf",516,"Fruits","Fruits",2019,54,54,0,5,54,59,5
27476,"Ring Levee Trail",29.785265,-90.110191,1044,"eastern poison ivy","Plantae","Deciduous broadleaf",371,"Leaves","Breaking leaf buds",2019,38,80,21,1,17,81,64
27476,"Ring Levee Trail",29.785265,-90.110191,1044,"eastern poison ivy","Plantae","Deciduous broadleaf",390,"Fruits","Ripe fruits",2019,87,87,6,14,81,101,20
27476,"Ring Levee Trail",29.785265,-90.110191,1044,"eastern poison ivy","Plantae","Deciduous broadleaf",467,"Leaves","Increasing leaf size",2019,73,81,14,20,59,101,42
27476,"Ring Levee Trail",29.785265,-90.110191,1044,"eastern poison ivy","Plantae","Deciduous broadleaf",483,"Leaves","Leaves",2019,54,54,16,5,38,59,21
27476,"Ring Levee Trail",29.785265,-90.110191,1044,"eastern poison ivy","Plantae","Deciduous broadleaf",501,"Flowers","Open flowers",2019,54,54,16,5,38,59,21
27476,"Ring Levee Trail",29.785265,-90.110191,1044,"eastern poison ivy","Plantae","Deciduous broadleaf",516,"Fruits","Fruits",2019,80,101,7,21,73,122,49
27476,"Ring Levee Trail",29.785265,-90.110191,1616,"possumhaw","Plantae","Deciduous broadleaf",371,"Leaves","Breaking leaf buds",2019,38,81,21,20,17,101,84
27476,"Ring Levee Trail",29.785265,-90.110191,1616,"possumhaw","Plantae","Deciduous broadleaf",467,"Leaves","Increasing leaf size",2019,38,101,21,21,17,122,105
27476,"Ring Levee Trail",29.785265,-90.110191,1616,"possumhaw","Plantae","Deciduous broadleaf",483,"Leaves","Leaves",2019,38,38,21,0,17,38,21
27476,"Ring Levee Trail",29.785265,-90.110191,1616,"possumhaw","Plantae","Deciduous broadleaf",500,"Flowers","Flowers or flower buds",2019,38,80,21,1,17,81,64
27476,"Ring Levee Trail",29.785265,-90.110191,1616,"possumhaw","Plantae","Deciduous broadleaf",501,"Flowers","Open flowers",2019,59,80,21,1,38,81,43
27476,"Ring Levee Trail",29.785265,-90.110191,1616,"possumhaw","Plantae","Deciduous broadleaf",516,"Fruits","Fruits",2019,80,101,7,21,73,122,49
27477,"Bayou Coquille Trail",29.793816,-90.122452,2,"boxelder","Plantae","Deciduous broadleaf",371,"Leaves","Breaking leaf buds",2019,84,89,14,18,70,107,37
27477,"Bayou Coquille Trail",29.793816,-90.122452,2,"boxelder","Plantae","Deciduous broadleaf",467,"Leaves","Increasing leaf size",2019,45,129,21,21,24,150,126
27477,"Bayou Coquille Trail",29.793816,-90.122452,2,"boxelder","Plantae","Deciduous broadleaf",483,"Leaves","Leaves",2019,45,45,21,0,24,45,21
27477,"Bayou Coquille Trail",29.793816,-90.122452,2,"boxelder","Plantae","Deciduous broadleaf",500,"Flowers","Flowers or flower buds",2019,45,67,21,3,24,70,46
27477,"Bayou Coquille Trail",29.793816,-90.122452,2,"boxelder","Plantae","Deciduous broadleaf",501,"Flowers","Open flowers",2019,45,67,21,3,24,70,46
27477,"Bayou Coquille Trail",29.793816,-90.122452,2,"boxelder","Plantae","Deciduous broadleaf",502,"Flowers","Pollen release (flowers)",2019,67,67,22,3,45,70,25
27477,"Bayou Coquille Trail",29.793816,-90.122452,2,"boxelder","Plantae","Deciduous broadleaf",504,"Fruits","Recent fruit or seed drop",2019,84,84,14,3,70,87,17
27477,"Bayou Coquille Trail",29.793816,-90.122452,3,"red maple","Plantae","Deciduous broadleaf",371,"Leaves","Breaking leaf buds",2019,77,89,12.5,18,64.5,107,42.5
27477,"Bayou Coquille Trail",29.793816,-90.122452,3,"red maple","Plantae","Deciduous broadleaf",390,"Fruits","Ripe fruits",2019,45,45,21,22,24,67,43
27477,"Bayou Coquille Trail",29.793816,-90.122452,3,"red maple","Plantae","Deciduous broadleaf",467,"Leaves","Increasing leaf size",2019,67,89,22,18,45,107,62
27477,"Bayou Coquille Trail",29.793816,-90.122452,3,"red maple","Plantae","Deciduous broadleaf",483,"Leaves","Leaves",2019,67,129,22,21,45,150,105
27477,"Bayou Coquille Trail",29.793816,-90.122452,3,"red maple","Plantae","Deciduous broadleaf",498,"Leaves","Colored leaves",2019,213,213,0,21,213,234,21
27477,"Bayou Coquille Trail",29.793816,-90.122452,3,"red maple","Plantae","Deciduous broadleaf",500,"Flowers","Flowers or flower buds",2019,24,45,21,22,3,67,64
27477,"Bayou Coquille Trail",29.793816,-90.122452,3,"red maple","Plantae","Deciduous broadleaf",501,"Flowers","Open flowers",2019,24,24,21,21,3,45,42
27477,"Bayou Coquille Trail",29.793816,-90.122452,3,"red maple","Plantae","Deciduous broadleaf",502,"Flowers","Pollen release (flowers)",2019,24,24,21,21,3,45,42
27477,"Bayou Coquille Trail",29.793816,-90.122452,3,"red maple","Plantae","Deciduous broadleaf",504,"Fruits","Recent fruit or seed drop",2019,89,89,2,18,87,107,20
27477,"Bayou Coquille Trail",29.793816,-90.122452,3,"red maple","Plantae","Deciduous broadleaf",516,"Fruits","Fruits",2019,45,45,21,22,24,67,43
27477,"Bayou Coquille Trail",29.793816,-90.122452,81,"sweetgum","Plantae","Deciduous broadleaf",371,"Leaves","Breaking leaf buds",2019,67,67,0,17,67,84,17
27477,"Bayou Coquille Trail",29.793816,-90.122452,81,"sweetgum","Plantae","Deciduous broadleaf",390,"Fruits","Ripe fruits",2019,89,89,2,18,87,107,20
27477,"Bayou Coquille Trail",29.793816,-90.122452,81,"sweetgum","Plantae","Deciduous broadleaf",467,"Leaves","Increasing leaf size",2019,45,87,21,20,24,107,83
27477,"Bayou Coquille Trail",29.793816,-90.122452,81,"sweetgum","Plantae","Deciduous broadleaf",483,"Leaves","Leaves",2019,45,45,21,0,24,45,21
27477,"Bayou Coquille Trail",29.793816,-90.122452,81,"sweetgum","Plantae","Deciduous broadleaf",500,"Flowers","Flowers or flower buds",2019,67,67,22,17,45,84,39
27477,"Bayou Coquille Trail",29.793816,-90.122452,81,"sweetgum","Plantae","Deciduous broadleaf",501,"Flowers","Open flowers",2019,67,67,22,17,45,84,39
27477,"Bayou Coquille Trail",29.793816,-90.122452,81,"sweetgum","Plantae","Deciduous broadleaf",504,"Fruits","Recent fruit or seed drop",2019,89,89,2,18,87,107,20
27477,"Bayou Coquille Trail",29.793816,-90.122452,81,"sweetgum","Plantae","Deciduous broadleaf",516,"Fruits","Fruits",2019,67,67,22,17,45,84,39
27477,"Bayou Coquille Trail",29.793816,-90.122452,201,"common buttonbush","Plantae","Deciduous broadleaf",371,"Leaves","Breaking leaf buds",2019,87,150,3,28,84,178,94
27477,"Bayou Coquille Trail",29.793816,-90.122452,201,"common buttonbush","Plantae","Deciduous broadleaf",390,"Fruits","Ripe fruits",2019,234,234,21,0,213,234,21
27477,"Bayou Coquille Trail",29.793816,-90.122452,201,"common buttonbush","Plantae","Deciduous broadleaf",467,"Leaves","Increasing leaf size",2019,87,213,3,21,84,234,150
27477,"Bayou Coquille Trail",29.793816,-90.122452,201,"common buttonbush","Plantae","Deciduous broadleaf",483,"Leaves","Leaves",2019,87,87,3,2,84,89,5
27477,"Bayou Coquille Trail",29.793816,-90.122452,201,"common buttonbush","Plantae","Deciduous broadleaf",500,"Flowers","Flowers or flower buds",2019,178,213,28,21,150,234,84
27477,"Bayou Coquille Trail",29.793816,-90.122452,201,"common buttonbush","Plantae","Deciduous broadleaf",501,"Flowers","Open flowers",2019,178,178,28,0,150,178,28
27477,"Bayou Coquille Trail",29.793816,-90.122452,201,"common buttonbush","Plantae","Deciduous broadleaf",516,"Fruits","Fruits",2019,234,234,21,0,213,234,21
27477,"Bayou Coquille Trail",29.793816,-90.122452,296,"bald cypress","Plantae","Deciduous conifer",392,"Seed cones","Unripe seed cones",2019,89,89,2,18,87,107,20
27477,"Bayou Coquille Trail",29.793816,-90.122452,296,"bald cypress","Plantae","Deciduous conifer",393,"Seed cones","Ripe seed cones",2019,129,129,22,0,107,129,22
27477,"Bayou Coquille Trail",29.793816,-90.122452,296,"bald cypress","Plantae","Deciduous conifer",481,"Needles","Breaking needle buds (deciduous)",2019,24,107,21,22,3,129,126
27477,"Bayou Coquille Trail",29.793816,-90.122452,296,"bald cypress","Plantae","Deciduous conifer",487,"Needles","Needles (deciduous)",2019,45,45,21,0,24,45,21
27477,"Bayou Coquille Trail",29.793816,-90.122452,296,"bald cypress","Plantae","Deciduous conifer",490,"Pollen cones","Pollen cones (conifers)",2019,87,89,20,18,67,107,40
27477,"Bayou Coquille Trail",29.793816,-90.122452,296,"bald cypress","Plantae","Deciduous conifer",491,"Seed cones","Recent cone or seed drop",2019,213,213,0,21,213,234,21
27477,"Bayou Coquille Trail",29.793816,-90.122452,296,"bald cypress","Plantae","Deciduous conifer",495,"Pollen cones","Open pollen cones (conifers)",2019,87,89,20,18,67,107,40
27477,"Bayou Coquille Trail",29.793816,-90.122452,296,"bald cypress","Plantae","Deciduous conifer",503,"Pollen cones","Pollen release (conifers)",2019,24,87,21,20,3,107,104
27477,"Bayou Coquille Trail",29.793816,-90.122452,305,"live oak","Plantae","Semi-evergreen broadleaf",371,"Leaves","Breaking leaf buds",2019,67,67,22,20,45,87,42
27477,"Bayou Coquille Trail",29.793816,-90.122452,305,"live oak","Plantae","Semi-evergreen broadleaf",467,"Leaves","Increasing leaf size",2019,67,87,22,20,45,107,62
27477,"Bayou Coquille Trail",29.793816,-90.122452,305,"live oak","Plantae","Semi-evergreen broadleaf",483,"Leaves","Leaves",2019,67,107,22,22,45,129,84
27477,"Bayou Coquille Trail",29.793816,-90.122452,305,"live oak","Plantae","Semi-evergreen broadleaf",484,"Leaves","Young leaves (tree/shrub)",2019,67,107,22,22,45,129,84
27477,"Bayou Coquille Trail",29.793816,-90.122452,305,"live oak","Plantae","Semi-evergreen broadleaf",500,"Flowers","Flowers or flower buds",2019,67,67,22,20,45,87,42
27477,"Bayou Coquille Trail",29.793816,-90.122452,305,"live oak","Plantae","Semi-evergreen broadleaf",501,"Flowers","Open flowers",2019,67,67,22,20,45,87,42
27477,"Bayou Coquille Trail",29.793816,-90.122452,305,"live oak","Plantae","Semi-evergreen broadleaf",516,"Fruits","Fruits",2019,129,129,22,0,107,129,22
27477,"Bayou Coquille Trail",29.793816,-90.122452,309,"trumpet creeper","Plantae","Deciduous broadleaf",371,"Leaves","Breaking leaf buds",2019,67,87,22,20,45,107,62
27477,"Bayou Coquille Trail",29.793816,-90.122452,309,"trumpet creeper","Plantae","Deciduous broadleaf",467,"Leaves","Increasing leaf size",2019,67,67,22,17,45,84,39
27477,"Bayou Coquille Trail",29.793816,-90.122452,309,"trumpet creeper","Plantae","Deciduous broadleaf",483,"Leaves","Leaves",2019,67,67,22,17,45,84,39
27477,"Bayou Coquille Trail",29.793816,-90.122452,309,"trumpet creeper","Plantae","Deciduous broadleaf",498,"Leaves","Colored leaves",2019,213,213,0,21,213,234,21
27477,"Bayou Coquille Trail",29.793816,-90.122452,309,"trumpet creeper","Plantae","Deciduous broadleaf",500,"Flowers","Flowers or flower buds",2019,150,150,21,0,129,150,21
27477,"Bayou Coquille Trail",29.793816,-90.122452,309,"trumpet creeper","Plantae","Deciduous broadleaf",501,"Flowers","Open flowers",2019,150,150,21,0,129,150,21
27477,"Bayou Coquille Trail",29.793816,-90.122452,722,"wax myrtle","Plantae","Evergreen broadleaf",371,"Leaves","Breaking leaf buds",2019,67,67,0,17,67,84,17
27477,"Bayou Coquille Trail",29.793816,-90.122452,722,"wax myrtle","Plantae","Evergreen broadleaf",484,"Leaves","Young leaves (tree/shrub)",2019,67,150,22,28,45,178,133
27477,"Bayou Coquille Trail",29.793816,-90.122452,722,"wax myrtle","Plantae","Evergreen broadleaf",500,"Flowers","Flowers or flower buds",2019,87,129,3,21,84,150,66
27477,"Bayou Coquille Trail",29.793816,-90.122452,722,"wax myrtle","Plantae","Evergreen broadleaf",501,"Flowers","Open flowers",2019,107,107,20,22,87,129,42
27477,"Bayou Coquille Trail",29.793816,-90.122452,804,"eastern baccharis","Plantae","Deciduous broadleaf",371,"Leaves","Breaking leaf buds",2019,24,89,21,18,3,107,104
27477,"Bayou Coquille Trail",29.793816,-90.122452,804,"eastern baccharis","Plantae","Deciduous broadleaf",467,"Leaves","Increasing leaf size",2019,24,129,21,21,3,150,147
27477,"Bayou Coquille Trail",29.793816,-90.122452,804,"eastern baccharis","Plantae","Deciduous broadleaf",500,"Flowers","Flowers or flower buds",2019,234,234,21,0,213,234,21
27477,"Bayou Coquille Trail",29.793816,-90.122452,940,"water tupelo ","Plantae","Deciduous broadleaf",371,"Leaves","Breaking leaf buds",2019,67,89,22,18,45,107,62
27477,"Bayou Coquille Trail",29.793816,-90.122452,940,"water tupelo ","Plantae","Deciduous broadleaf",390,"Fruits","Ripe fruits",2019,129,129,22,0,107,129,22
27477,"Bayou Coquille Trail",29.793816,-90.122452,940,"water tupelo ","Plantae","Deciduous broadleaf",467,"Leaves","Increasing leaf size",2019,67,89,22,18,45,107,62
27477,"Bayou Coquille Trail",29.793816,-90.122452,940,"water tupelo ","Plantae","Deciduous broadleaf",483,"Leaves","Leaves",2019,67,67,22,0,45,67,22
27477,"Bayou Coquille Trail",29.793816,-90.122452,940,"water tupelo ","Plantae","Deciduous broadleaf",500,"Flowers","Flowers or flower buds",2019,45,87,21,2,24,89,65
27477,"Bayou Coquille Trail",29.793816,-90.122452,940,"water tupelo ","Plantae","Deciduous broadleaf",516,"Fruits","Fruits",2019,107,107,18,0,89,107,18
27477,"Bayou Coquille Trail",29.793816,-90.122452,1044,"eastern poison ivy","Plantae","Deciduous broadleaf",371,"Leaves","Breaking leaf buds",2019,87,89,3,18,84,107,23
27477,"Bayou Coquille Trail",29.793816,-90.122452,1044,"eastern poison ivy","Plantae","Deciduous broadleaf",390,"Fruits","Ripe fruits",2019,3,3,0,21,3,24,21
27477,"Bayou Coquille Trail",29.793816,-90.122452,1044,"eastern poison ivy","Plantae","Deciduous broadleaf",467,"Leaves","Increasing leaf size",2019,67,89,22,18,45,107,62
27477,"Bayou Coquille Trail",29.793816,-90.122452,1044,"eastern poison ivy","Plantae","Deciduous broadleaf",471,"Leaves","Falling leaves",2019,89,89,2,18,87,107,20
27477,"Bayou Coquille Trail",29.793816,-90.122452,1044,"eastern poison ivy","Plantae","Deciduous broadleaf",483,"Leaves","Leaves",2019,67,67,22,0,45,67,22
27477,"Bayou Coquille Trail",29.793816,-90.122452,1044,"eastern poison ivy","Plantae","Deciduous broadleaf",498,"Leaves","Colored leaves",2019,89,89,2,18,87,107,20
27477,"Bayou Coquille Trail",29.793816,-90.122452,1044,"eastern poison ivy","Plantae","Deciduous broadleaf",500,"Flowers","Flowers or flower buds",2019,89,129,2,21,87,150,63
27477,"Bayou Coquille Trail",29.793816,-90.122452,1044,"eastern poison ivy","Plantae","Deciduous broadleaf",501,"Flowers","Open flowers",2019,107,107,18,22,89,129,40
27477,"Bayou Coquille Trail",29.793816,-90.122452,1044,"eastern poison ivy","Plantae","Deciduous broadleaf",502,"Flowers","Pollen release (flowers)",2019,107,107,18,22,89,129,40
27477,"Bayou Coquille Trail",29.793816,-90.122452,1044,"eastern poison ivy","Plantae","Deciduous broadleaf",516,"Fruits","Fruits",2019,87,150,20,28,67,178,111
27477,"Bayou Coquille Trail",29.793816,-90.122452,1605,"sugarberry","Plantae","Deciduous broadleaf",371,"Leaves","Breaking leaf buds",2019,24,87,21,20,3,107,104
27477,"Bayou Coquille Trail",29.793816,-90.122452,1605,"sugarberry","Plantae","Deciduous broadleaf",390,"Fruits","Ripe fruits",2019,129,129,22,0,107,129,22
27477,"Bayou Coquille Trail",29.793816,-90.122452,1605,"sugarberry","Plantae","Deciduous broadleaf",467,"Leaves","Increasing leaf size",2019,67,107,22,22,45,129,84
27477,"Bayou Coquille Trail",29.793816,-90.122452,1605,"sugarberry","Plantae","Deciduous broadleaf",483,"Leaves","Leaves",2019,67,67,22,0,45,67,22
27477,"Bayou Coquille Trail",29.793816,-90.122452,1605,"sugarberry","Plantae","Deciduous broadleaf",516,"Fruits","Fruits",2019,87,87,20,20,67,107,40
27477,"Bayou Coquille Trail",29.793816,-90.122452,1616,"possumhaw","Plantae","Deciduous broadleaf",371,"Leaves","Breaking leaf buds",2019,45,87,21,2,24,89,65
27477,"Bayou Coquille Trail",29.793816,-90.122452,1616,"possumhaw","Plantae","Deciduous broadleaf",390,"Fruits","Ripe fruits",2019,87,213,3,21,84,234,150
27477,"Bayou Coquille Trail",29.793816,-90.122452,1616,"possumhaw","Plantae","Deciduous broadleaf",467,"Leaves","Increasing leaf size",2019,45,150,21,28,24,178,154
27477,"Bayou Coquille Trail",29.793816,-90.122452,1616,"possumhaw","Plantae","Deciduous broadleaf",471,"Leaves","Falling leaves",2019,234,234,21,0,213,234,21
27477,"Bayou Coquille Trail",29.793816,-90.122452,1616,"possumhaw","Plantae","Deciduous broadleaf",483,"Leaves","Leaves",2019,45,107,21,22,24,129,105
27477,"Bayou Coquille Trail",29.793816,-90.122452,1616,"possumhaw","Plantae","Deciduous broadleaf",500,"Flowers","Flowers or flower buds",2019,67,89,22,18,45,107,62
27477,"Bayou Coquille Trail",29.793816,-90.122452,1616,"possumhaw","Plantae","Deciduous broadleaf",501,"Flowers","Open flowers",2019,84,89,17,18,67,107,40
27477,"Bayou Coquille Trail",29.793816,-90.122452,1616,"possumhaw","Plantae","Deciduous broadleaf",504,"Fruits","Recent fruit or seed drop",2019,89,89,2,18,87,107,20
